what is the highest point in florida ?	_answer ( NV , _highest ( V0 , ( _place ( V0 ) , _loc ( V0 , NV ) , _const ( V0 , _stateid ( florida ) ) ) ) )
what are the high points of states surrounding mississippi ?	_answer ( NV , ( _high_point ( NV , V1 ) , _loc ( V1 , V0 ) , _state ( V0 ) , _next_to ( V0 , NV ) , _const ( V0 , _stateid ( mississippi ) ) ) )
what state has the shortest river ?	_answer ( NV , ( _state ( V0 ) , _loc ( NV , V1 ) , _shortest ( V0 , _river ( V0 ) ) ) )
what is the tallest mountain in the united states ?	_answer ( NV , _highest ( V0 , ( _mountain ( V0 ) , _loc ( V0 , NV ) , _const ( V0 , _countryid ( usa ) ) ) ) )
what is the capital of maine ?	_answer ( NV , ( _capital ( V0 ) , _loc ( V0 , NV ) , _const ( V0 , _stateid ( maine ) ) ) )
what are the populations of states through which the mississippi river run ?	_answer ( NV , ( _population ( NV , V1 ) , _state ( V0 ) , _const ( NV , _riverid ( mississippi ) ) , _river ( V0 ) , _traverse ( V0 , V1 ) ) )
name all the lakes of us ?	_answer ( NV , ( _lake ( V0 ) , _loc ( V0 , NV ) , _const ( V0 , _countryid ( usa ) ) ) )
which states border states through which the mississippi traverses ?	_answer ( NV , ( _state ( V0 ) , _next_to ( V0 , NV ) , _state ( V0 ) , _const ( NV , _riverid ( mississippi ) ) , _traverse ( V0 , V1 ) ) )
what is the highest mountain in alaska ?	_answer ( NV , _highest ( V0 , ( _mountain ( V0 ) , _loc ( V0 , NV ) , _const ( V0 , _stateid ( alaska ) ) ) ) )
what is the population of illinois ?	_answer ( NV , ( _population ( NV , V1 ) , _const ( V0 , _stateid ( illinois ) ) ) )
name all the rivers in colorado ?	_answer ( NV , ( _river ( V0 ) , _loc ( V0 , NV ) , _const ( V0 , _stateid ( colorado ) ) ) )
in which state does the highest point in usa exist ?	_answer ( NV , ( _loc ( NV , V1 ) , _state ( V1 ) , _highest ( V0 , ( _place ( V0 ) , _loc ( V0 , NV ) , _const ( V0 , _countryid ( usa ) ) ) ) ) )
which state is the city denver located in ?	_answer ( NV , ( _state ( V0 ) , _city ( NV ) , _const ( V0 , _cityid ( denver , _ ) ) , _loc ( V0 , V1 ) ) )
what is the lowest point in texas ?	_answer ( NV , _lowest ( V0 , ( _place ( V0 ) , _loc ( V0 , NV ) , _const ( V0 , _stateid ( texas ) ) ) ) )
how many states have a city called rochester ?	_answer ( NV , _count ( NV , ( _state ( V0 ) , _loc ( NV , V1 ) , _const ( V0 , _cityid ( rochester , _ ) ) ) , V2 ) )
which capitals are in the states that border texas ?	_answer ( NV , ( _capital ( V0 ) , _loc ( V0 , NV ) , _state ( V0 ) , _next_to ( V0 , NV ) , _const ( V0 , _stateid ( texas ) ) ) )
how many people live in austin ?	_answer ( NV , ( _population ( NV , V1 ) , _const ( V0 , _cityid ( austin , _ ) ) ) )
what states have rivers named colorado ?	_answer ( NV , ( _state ( V0 ) , _loc ( NV , V1 ) , _const ( V0 , _riverid ( colorado ) ) ) )
what is the size of texas ?	_answer ( NV , ( _size ( NV , V1 ) , _const ( V0 , _stateid ( texas ) ) ) )
what is the shortest river in the usa ?	_answer ( NV , _shortest ( V0 , ( _river ( V0 ) , _loc ( V0 , NV ) , _const ( V0 , _countryid ( usa ) ) ) ) )
what are the major cities of the us ?	_answer ( NV , ( _major ( V0 ) , _city ( V0 ) , _loc ( V0 , NV ) , _const ( V0 , _countryid ( usa ) ) ) )
which state border kentucky ?	_answer ( NV , ( _state ( V0 ) , _next_to ( V0 , NV ) , _const ( V0 , _stateid ( kentucky ) ) ) )
what is the population of oregon ?	_answer ( NV , ( _population ( NV , V1 ) , _const ( V0 , _stateid ( oregon ) ) ) )
what states have a city named austin ?	_answer ( NV , ( _state ( V0 ) , _loc ( NV , V1 ) , _const ( V0 , _cityid ( austin , _ ) ) ) )
what is the highest elevation in south carolina ?	_answer ( NV , _highest ( V0 , ( _place ( V0 ) , _loc ( V0 , NV ) , _const ( V0 , _stateid ( ' south carolina ' ) ) ) ) )
how many people live in austin texas ?	_answer ( NV , ( _population ( NV , V1 ) , _const ( V0 , _cityid ( austin , tx ) ) ) )
what are the rivers in the state of texas ?	_answer ( NV , ( _river ( V0 ) , _loc ( V0 , NV ) , _state ( V0 ) , _const ( V0 , _stateid ( texas ) ) ) )
what is the lowest point of colorado ?	_answer ( NV , _lowest ( V0 , ( _place ( V0 ) , _loc ( V0 , NV ) , _const ( V0 , _stateid ( colorado ) ) ) ) )
what is the population of atlanta ?	_answer ( NV , ( _population ( NV , V1 ) , _const ( V0 , _cityid ( atlanta , _ ) ) ) )
what rivers are in utah ?	_answer ( NV , ( _river ( V0 ) , _loc ( V0 , NV ) , _const ( V0 , _stateid ( utah ) ) ) )
what river runs through the most states ?	_answer ( NV , _most ( V0 , NV , ( _river ( V1 ) , _traverse ( V1 , V0 ) , _state ( V0 ) ) ) )
what is the population of sacramento ?	_answer ( NV , ( _population ( NV , V1 ) , _const ( V0 , _cityid ( sacramento , _ ) ) ) )
could you tell me what is the highest point in the state of oregon ?	_answer ( NV , _highest ( V0 , ( _place ( V0 ) , _loc ( V0 , NV ) , _state ( V0 ) , _const ( V0 , _stateid ( oregon ) ) ) ) )
which states does the mississippi river run through ?	_answer ( NV , ( _state ( V0 ) , _const ( NV , _riverid ( mississippi ) ) , _river ( V0 ) , _traverse ( V0 , V1 ) ) )
what are the major cities in the smallest state in the us ?	_answer ( NV , ( _major ( V0 ) , _city ( V0 ) , _loc ( V0 , NV ) , _smallest ( V0 , ( _state ( V0 ) , _loc ( V0 , NV ) , _const ( V0 , _countryid ( usa ) ) ) ) ) )
how high is guadalupe peak ?	_answer ( NV , ( _elevation ( NV , V1 ) , _const ( V0 , _placeid ( ' guadalupe peak ' ) ) ) )
what river runs through illinois ?	_answer ( NV , ( _river ( V0 ) , _traverse ( V0 , NV ) , _const ( V0 , _stateid ( illinois ) ) ) )
how long is the mississippi river ?	_answer ( NV , ( _len ( NV , V1 ) , _const ( V0 , _riverid ( mississippi ) ) , _river ( V0 ) ) )
how high is the highest point in the largest state ?	_answer ( NV , ( _elevation ( NV , V1 ) , _highest ( V0 , ( _place ( V0 ) , _loc ( V0 , NV ) , _largest ( V0 , _state ( V0 ) ) ) ) ) )
what is the area of south carolina ?	_answer ( NV , ( _area ( NV , V1 ) , _const ( V0 , _stateid ( ' south carolina ' ) ) ) )
what are the states through which the longest river runs ?	_answer ( NV , ( _state ( V0 ) , _longest ( NV , ( _river ( V0 ) , _traverse ( V0 , V1 ) ) ) ) )
where is new orleans ?	_answer ( NV , ( _loc ( NV , V1 ) , _const ( V0 , _cityid ( ' new orleans ' , _ ) ) ) )
in what state is mount mckinley ?	_answer ( NV , ( _loc ( NV , V1 ) , _state ( V1 ) , _const ( V0 , _placeid ( ' mount mckinley ' ) ) ) )
what state has highest elevation ?	_answer ( NV , ( _state ( V0 ) , _loc ( NV , V1 ) , _highest ( V0 , _place ( V0 ) ) ) )
what is the size of california ?	_answer ( NV , ( _size ( NV , V1 ) , _const ( V0 , _stateid ( california ) ) ) )
what is the smallest state that borders texas ?	_answer ( NV , _smallest ( V0 , ( _state ( V0 ) , _next_to ( V0 , NV ) , _const ( V0 , _stateid ( texas ) ) ) ) )
how many citizens in alabama ?	_answer ( NV , ( _population ( NV , V1 ) , _const ( V0 , _stateid ( alabama ) ) ) )
in which state is rochester ?	_answer ( NV , ( _loc ( NV , V1 ) , _state ( V1 ) , _const ( V0 , _cityid ( rochester , _ ) ) ) )
how many states in the us does the shortest river run through ?	_answer ( NV , _count ( NV , ( _state ( V0 ) , _loc ( V0 , NV ) , _const ( V0 , _countryid ( usa ) ) , _shortest ( NV , _river ( V0 ) ) , _traverse ( V0 , V2 ) ) , V3 ) )
what is the biggest state in continental us ?	_answer ( NV , _largest ( V0 , ( _state ( V0 ) , _loc ( V0 , NV ) , _const ( V0 , _countryid ( usa ) ) ) ) )
what is the area of the largest state ?	_answer ( NV , ( _area ( NV , V1 ) , _largest ( V0 , _state ( V0 ) ) ) )
where is mount whitney ?	_answer ( NV , ( _loc ( NV , V1 ) , _const ( V0 , _placeid ( ' mount whitney ' ) ) ) )
how many states does iowa border ?	_answer ( NV , _count ( NV , ( _state ( V0 ) , _const ( NV , _stateid ( iowa ) ) , _next_to ( V0 , V1 ) ) , V2 ) )
which states does the longest river cross ?	_answer ( NV , ( _state ( V0 ) , _longest ( NV , _river ( V0 ) ) , _traverse ( V0 , V1 ) ) )
what river flows through kansas ?	_answer ( NV , ( _river ( V0 ) , _traverse ( V0 , NV ) , _const ( V0 , _stateid ( kansas ) ) ) )
what is the population of austin texas ?	_answer ( NV , ( _population ( NV , V1 ) , _const ( V0 , _cityid ( austin , tx ) ) ) )
what is the capital of vermont ?	_answer ( NV , ( _capital ( V0 ) , _loc ( V0 , NV ) , _const ( V0 , _stateid ( vermont ) ) ) )
which states border colorado ?	_answer ( NV , ( _state ( V0 ) , _next_to ( V0 , NV ) , _const ( V0 , _stateid ( colorado ) ) ) )
how long is the mississippi ?	_answer ( NV , ( _len ( NV , V1 ) , _const ( V0 , _riverid ( mississippi ) ) ) )
what state has the largest population density ?	_answer ( NV , _largest ( NV , ( _state ( V1 ) , _density ( V1 , V0 ) ) ) )
what states border georgia ?	_answer ( NV , ( _state ( V0 ) , _next_to ( V0 , NV ) , _const ( V0 , _stateid ( georgia ) ) ) )
what is the capital of pennsylvania ?	_answer ( NV , ( _capital ( V0 ) , _loc ( V0 , NV ) , _const ( V0 , _stateid ( pennsylvania ) ) ) )
what are the biggest rivers in texas ?	_answer ( NV , _longest ( V0 , ( _river ( V0 ) , _loc ( V0 , NV ) , _const ( V0 , _stateid ( texas ) ) ) ) )
what is the longest river in the united states ?	_answer ( NV , _longest ( V0 , ( _river ( V0 ) , _loc ( V0 , NV ) , _const ( V0 , _countryid ( usa ) ) ) ) )
what is the capital of utah ?	_answer ( NV , ( _capital ( V0 ) , _loc ( V0 , NV ) , _const ( V0 , _stateid ( utah ) ) ) )
what state has the smallest population density ?	_answer ( NV , _smallest ( NV , ( _state ( V1 ) , _density ( V1 , V0 ) ) ) )
which capitals are not major cities ?	_answer ( NV , ( _capital ( V0 ) , \+ ( _major ( V0 ) , _city ( V0 ) ) ) )
what is the biggest city in nebraska ?	_answer ( NV , _largest ( V0 , ( _city ( V0 ) , _loc ( V0 , NV ) , _const ( V0 , _stateid ( nebraska ) ) ) ) )
what is the population of texas ?	_answer ( NV , ( _population ( NV , V1 ) , _const ( V0 , _stateid ( texas ) ) ) )
what is the shortest river in the united states ?	_answer ( NV , _shortest ( V0 , ( _river ( V0 ) , _loc ( V0 , NV ) , _const ( V0 , _countryid ( usa ) ) ) ) )
what is the population of rhode island ?	_answer ( NV , ( _population ( NV , V1 ) , _const ( V0 , _stateid ( ' rhode island ' ) ) ) )
what is the state with the lowest point ?	_answer ( NV , ( _state ( V0 ) , _loc ( NV , V1 ) , _lowest ( V0 , _place ( V0 ) ) ) )
what is the longest river in new york ?	_answer ( NV , _longest ( V0 , ( _river ( V0 ) , _loc ( V0 , NV ) , _const ( V0 , _stateid ( ' new york ' ) ) ) ) )
what is the longest river that runs through a state that borders tennessee ?	_answer ( NV , _longest ( V0 , ( _river ( V0 ) , _traverse ( V0 , NV ) , _state ( V0 ) , _next_to ( V0 , NV ) , _const ( V0 , _stateid ( tennessee ) ) ) ) )
how many major cities are in arizona ?	_answer ( NV , _count ( NV , ( _major ( V0 ) , _city ( V0 ) , _loc ( V0 , NV ) , _const ( V0 , _stateid ( arizona ) ) ) , V2 ) )
what are the neighboring states for michigan ?	_answer ( NV , ( _next_to ( V0 , NV ) , _state ( V1 ) , _const ( V0 , _stateid ( michigan ) ) ) )
what state that borders texas is the largest ?	_answer ( NV , _largest ( V0 , ( _state ( V0 ) , _next_to ( V0 , NV ) , _const ( V0 , _stateid ( texas ) ) ) ) )
what is the shortest river ?	_answer ( NV , _shortest ( V0 , _river ( V0 ) ) )
how many states border the state that borders the most states ?	_answer ( NV , _count ( NV , ( _state ( V0 ) , _next_to ( V0 , NV ) , _most ( V0 , NV , ( _state ( V1 ) , _next_to ( V1 , V0 ) , _state ( V0 ) ) ) ) , V3 ) )
which state is the largest city in montana in ?	_answer ( NV , ( _state ( V0 ) , _largest ( NV , ( _city ( V0 ) , _loc ( V0 , NV ) , _const ( V0 , _stateid ( montana ) ) ) ) , _loc ( V1 , V2 ) ) )
what is the population of washington dc ?	_answer ( NV , ( _population ( NV , V1 ) , _const ( V0 , _cityid ( washington , dc ) ) ) )
what is the most populous city in texas ?	_answer ( NV , _largest ( NV , ( _population ( V1 , V0 ) , _city ( V1 ) , _loc ( V1 , NV ) , _const ( V0 , _stateid ( texas ) ) ) ) )
what is the capital of hawaii ?	_answer ( NV , ( _capital ( V0 ) , _loc ( V0 , NV ) , _const ( V0 , _stateid ( hawaii ) ) ) )
what is capital of iowa ?	_answer ( NV , ( _capital ( V0 ) , _loc ( V0 , NV ) , _const ( V0 , _stateid ( iowa ) ) ) )
where is san diego ?	_answer ( NV , ( _loc ( NV , V1 ) , _const ( V0 , _cityid ( ' san diego ' , _ ) ) ) )
what are the major cities in delaware ?	_answer ( NV , ( _major ( V0 ) , _city ( V0 ) , _loc ( V0 , NV ) , _const ( V0 , _stateid ( delaware ) ) ) )
what is the lowest point in louisiana ?	_answer ( NV , _lowest ( V0 , ( _place ( V0 ) , _loc ( V0 , NV ) , _const ( V0 , _stateid ( louisiana ) ) ) ) )
which state has the highest peak in the country ?	_answer ( NV , _highest ( NV , ( _state ( V1 ) , _loc ( V0 , V1 ) , _mountain ( V0 ) ) ) )
what texas city has the largest population ?	_answer ( NV , _largest ( NV , ( _const ( NV , _stateid ( texas ) ) , _city ( V2 ) , _loc ( V2 , V0 ) , _population ( V2 , V1 ) ) ) )
what capital is the largest in the us ?	_answer ( NV , _largest ( V0 , ( _capital ( V0 ) , _loc ( V0 , NV ) , _const ( V0 , _countryid ( usa ) ) ) ) )
what is the population of new york ?	_answer ( NV , ( _population ( NV , V1 ) , _const ( V0 , _stateid ( ' new york ' ) ) ) )
what is the population of the capital of the smallest state ?	_answer ( NV , ( _population ( NV , V1 ) , _capital ( V0 ) , _loc ( V0 , NV ) , _smallest ( V0 , _state ( V0 ) ) ) )
what is the area of alaska ?	_answer ( NV , ( _area ( NV , V1 ) , _const ( V0 , _stateid ( alaska ) ) ) )
what is the population of california ?	_answer ( NV , ( _population ( NV , V1 ) , _const ( V0 , _stateid ( california ) ) ) )
which state has the longest river ?	_answer ( NV , _longest ( NV , ( _state ( V1 ) , _loc ( V0 , V1 ) , _river ( V0 ) ) ) )
what is the capital of texas ?	_answer ( NV , ( _capital ( V0 ) , _loc ( V0 , NV ) , _const ( V0 , _stateid ( texas ) ) ) )
give me the cities which are in texas ?	_answer ( NV , ( _city ( V0 ) , _loc ( V0 , NV ) , _const ( V0 , _stateid ( texas ) ) ) )
what states border kentucky ?	_answer ( NV , ( _state ( V0 ) , _next_to ( V0 , NV ) , _const ( V0 , _stateid ( kentucky ) ) ) )
how high is the highest point of florida ?	_answer ( NV , ( _elevation ( NV , V1 ) , _highest ( V0 , ( _place ( V0 ) , _loc ( V0 , NV ) , _const ( V0 , _stateid ( florida ) ) ) ) ) )
what are the major cities in north carolina ?	_answer ( NV , ( _major ( V0 ) , _city ( V0 ) , _loc ( V0 , NV ) , _const ( V0 , _stateid ( ' north carolina ' ) ) ) )
what is the highest point in the state with capital des moines ?	_answer ( NV , _highest ( V0 , ( _place ( V0 ) , _loc ( V0 , NV ) , _state ( V0 ) , _loc ( NV , V1 ) , _capital ( V0 ) , _const ( V0 , _cityid ( ' des moines ' , _ ) ) ) ) )
what is the lowest point in california ?	_answer ( NV , _lowest ( V0 , ( _place ( V0 ) , _loc ( V0 , NV ) , _const ( V0 , _stateid ( california ) ) ) ) )
what is the biggest city in wyoming ?	_answer ( NV , _largest ( V0 , ( _city ( V0 ) , _loc ( V0 , NV ) , _const ( V0 , _stateid ( wyoming ) ) ) ) )
what is the largest state bordering texas ?	_answer ( NV , _largest ( V0 , ( _state ( V0 ) , _next_to ( V0 , NV ) , _const ( V0 , _stateid ( texas ) ) ) ) )
what is the smallest city in hawaii ?	_answer ( NV , _smallest ( V0 , ( _city ( V0 ) , _loc ( V0 , NV ) , _const ( V0 , _stateid ( hawaii ) ) ) ) )
what is the area of the states ?	_answer ( NV , ( _area ( NV , V1 ) , _state ( V0 ) ) )
what is the area of idaho ?	_answer ( NV , ( _area ( NV , V1 ) , _const ( V0 , _stateid ( idaho ) ) ) )
what state has the most rivers running through it ?	_answer ( NV , _most ( V0 , NV , ( _state ( V1 ) , _loc ( V0 , V1 ) , _river ( V0 ) , _traverse ( V0 , V1 ) ) ) )
what is the population of springfield missouri ?	_answer ( NV , ( _population ( NV , V1 ) , _const ( V0 , _cityid ( springfield , mo ) ) ) )
what is the most populated state bordering oklahoma ?	_answer ( NV , _largest ( NV , ( _population ( V1 , V0 ) , _state ( V1 ) , _next_to ( V1 , NV ) , _const ( V0 , _stateid ( oklahoma ) ) ) ) )
what is the number of neighboring states for kentucky ?	_answer ( NV , _count ( NV , ( _state ( V0 ) , _next_to ( V0 , NV ) , _const ( V0 , _stateid ( kentucky ) ) ) , V2 ) )
what is the average population per square km in pennsylvania ?	_answer ( NV , ( _density ( NV , V1 ) , _const ( V0 , _stateid ( pennsylvania ) ) ) )
what state has the highest population density ?	_answer ( NV , _largest ( NV , ( _state ( V1 ) , _density ( V1 , V0 ) ) ) )
what is the tallest mountain in america ?	_answer ( NV , _highest ( V0 , ( _mountain ( V0 ) , _loc ( V0 , NV ) , _const ( V0 , _countryid ( usa ) ) ) ) )
what is the highest point of the state with the largest area ?	_answer ( NV , _highest ( V0 , ( _place ( V0 ) , _loc ( V0 , NV ) , _largest ( NV , ( _state ( V1 ) , _area ( V1 , V0 ) ) ) ) ) )
what are the states ?	_answer ( NV , _state ( V0 ) )
how many rivers in washington ?	_answer ( NV , _count ( NV , ( _river ( V0 ) , _loc ( V0 , NV ) , _const ( V0 , _stateid ( washington ) ) ) , V2 ) )
what are the populations of the states through which the mississippi river run ?	_answer ( NV , ( _population ( NV , V1 ) , _state ( V0 ) , _const ( NV , _riverid ( mississippi ) ) , _river ( V0 ) , _traverse ( V0 , V1 ) ) )
what is the biggest river in illinois ?	_answer ( NV , _largest ( V0 , ( _river ( V0 ) , _loc ( V0 , NV ) , _const ( V0 , _stateid ( illinois ) ) ) ) )
what is the capital of michigan ?	_answer ( NV , ( _capital ( V0 ) , _loc ( V0 , NV ) , _const ( V0 , _stateid ( michigan ) ) ) )
what is the total population of the states that border texas ?	_answer ( NV , _sum ( NV , ( _state ( V0 ) , _next_to ( NV , V1 ) , _const ( V0 , _stateid ( texas ) ) ) , _population ( V1 ) , V2 ) )
what states border rhode island ?	_answer ( NV , ( _state ( V0 ) , _next_to ( V0 , NV ) , _const ( V0 , _stateid ( ' rhode island ' ) ) ) )
what is the biggest city in oregon ?	_answer ( NV , _largest ( V0 , ( _city ( V0 ) , _loc ( V0 , NV ) , _const ( V0 , _stateid ( oregon ) ) ) ) )
what is the lowest point in wisconsin ?	_answer ( NV , _lowest ( V0 , ( _place ( V0 ) , _loc ( V0 , NV ) , _const ( V0 , _stateid ( wisconsin ) ) ) ) )
what are the rivers in the state of indiana ?	_answer ( NV , ( _river ( V0 ) , _loc ( V0 , NV ) , _state ( V0 ) , _const ( V0 , _stateid ( indiana ) ) ) )
what is the population of austin ?	_answer ( NV , ( _population ( NV , V1 ) , _const ( V0 , _cityid ( austin , _ ) ) ) )
what is the smallest city in arkansas ?	_answer ( NV , _smallest ( V0 , ( _city ( V0 ) , _loc ( V0 , NV ) , _const ( V0 , _stateid ( arkansas ) ) ) ) )
give me the longest river that passes through the us ?	_answer ( NV , _longest ( V0 , ( _river ( V0 ) , _traverse ( V0 , NV ) , _const ( V0 , _countryid ( usa ) ) ) ) )
how long is the missouri river ?	_answer ( NV , ( _len ( NV , V1 ) , _const ( V0 , _riverid ( missouri ) ) , _river ( V0 ) ) )
which state has the largest city ?	_answer ( NV , _largest ( NV , ( _state ( V1 ) , _loc ( V0 , V1 ) , _city ( V0 ) ) ) )
what is the lowest elevation in pennsylvania ?	_answer ( NV , _lowest ( V0 , ( _place ( V0 ) , _loc ( V0 , NV ) , _const ( V0 , _stateid ( pennsylvania ) ) ) ) )
what is the longest river in the state with the highest point ?	_answer ( NV , _longest ( V0 , ( _river ( V0 ) , _loc ( V0 , NV ) , _state ( V0 ) , _loc ( NV , V1 ) , _highest ( V0 , _place ( V0 ) ) ) ) )
what states does the colorado river run through ?	_answer ( NV , ( _state ( V0 ) , _const ( NV , _riverid ( colorado ) ) , _river ( V0 ) , _traverse ( V0 , V1 ) ) )
what are the states that the potomac run through ?	_answer ( NV , ( _state ( V0 ) , _const ( NV , _riverid ( potomac ) ) , _traverse ( V0 , V1 ) ) )
what is the biggest city in the usa ?	_answer ( NV , _largest ( V0 , ( _city ( V0 ) , _loc ( V0 , NV ) , _const ( V0 , _countryid ( usa ) ) ) ) )
what state has no rivers ?	_answer ( NV , ( _state ( V0 ) , \+ ( _loc ( NV , V1 ) , _river ( V0 ) ) ) )
what is the highest point in rhode island ?	_answer ( NV , _highest ( V0 , ( _place ( V0 ) , _loc ( V0 , NV ) , _const ( V0 , _stateid ( ' rhode island ' ) ) ) ) )
name the states which have no surrounding states ?	_answer ( NV , ( _state ( V0 ) , \+ ( _next_to ( V0 , NV ) , _state ( V0 ) ) ) )
what is the population of atlanta ga ?	_answer ( NV , ( _population ( NV , V1 ) , _const ( V0 , _cityid ( atlanta , _ ) ) ) )
how many square kilometers in the us ?	_answer ( NV , ( _area ( NV , V1 ) , _const ( V0 , _countryid ( usa ) ) ) )
what is the population of idaho ?	_answer ( NV , ( _population ( NV , V1 ) , _const ( V0 , _stateid ( idaho ) ) ) )
what is the adjacent state of california ?	_answer ( NV , ( _next_to ( V0 , NV ) , _state ( V1 ) , _const ( V0 , _stateid ( california ) ) ) )
what is the smallest state through which the longest river runs ?	_answer ( NV , _smallest ( V0 , ( _state ( V0 ) , _longest ( NV , _river ( V0 ) ) , _traverse ( V0 , V1 ) ) ) )
what are the names of the major cities in illinois ?	_answer ( NV , ( _major ( V0 ) , _city ( V0 ) , _loc ( V0 , NV ) , _const ( V0 , _stateid ( illinois ) ) ) )
how many states does the colorado river run through ?	_answer ( NV , _count ( NV , ( _state ( V0 ) , _const ( NV , _riverid ( colorado ) ) , _river ( V0 ) , _traverse ( V0 , V1 ) ) , V2 ) )
how many states does the colorado river flow through ?	_answer ( NV , _count ( NV , ( _state ( V0 ) , _const ( NV , _riverid ( colorado ) ) , _river ( V0 ) , _traverse ( V0 , V1 ) ) , V2 ) )
what are the major cities in kansas ?	_answer ( NV , ( _major ( V0 ) , _city ( V0 ) , _loc ( V0 , NV ) , _const ( V0 , _stateid ( kansas ) ) ) )
which states border texas ?	_answer ( NV , ( _state ( V0 ) , _next_to ( V0 , NV ) , _const ( V0 , _stateid ( texas ) ) ) )
how many people live in new york ?	_answer ( NV , ( _population ( NV , V1 ) , _const ( V0 , _stateid ( ' new york ' ) ) ) )
what are the largest cities in the states that border the largest state ?	_answer ( NV , _largest ( V0 , ( _city ( V0 ) , _loc ( V0 , NV ) , _state ( V0 ) , _next_to ( V0 , NV ) , _largest ( V0 , _state ( V0 ) ) ) ) )
which states have points that are higher than the highest point in texas ?	_answer ( NV , ( _state ( V0 ) , _place ( NV ) , _loc ( V0 , V1 ) , _higher ( V0 , NV ) , _highest ( V0 , ( _place ( V0 ) , _loc ( V0 , NV ) , _const ( V0 , _stateid ( texas ) ) ) ) ) )
what is the river that cross over ohio ?	_answer ( NV , ( _river ( V0 ) , _traverse ( V0 , NV ) , _const ( V0 , _stateid ( ohio ) ) ) )
what is the largest city in michigan ?	_answer ( NV , _largest ( V0 , ( _city ( V0 ) , _loc ( V0 , NV ) , _const ( V0 , _stateid ( michigan ) ) ) ) )
how many rivers are in the state with the highest point ?	_answer ( NV , _count ( NV , ( _river ( V0 ) , _loc ( V0 , NV ) , _state ( V0 ) , _loc ( NV , V1 ) , _highest ( V0 , _place ( V0 ) ) ) , V3 ) )
what cities are located in pennsylvania ?	_answer ( NV , ( _city ( V0 ) , _loc ( V0 , NV ) , _const ( V0 , _stateid ( pennsylvania ) ) ) )
what is the state with the lowest population ?	_answer ( NV , _smallest ( NV , ( _state ( V1 ) , _population ( V1 , V0 ) ) ) )
what is the highest point in each state whose lowest point is sea level ?	_answer ( NV , ( _high_point ( NV , V1 ) , _state ( V0 ) , _low_point ( V0 , NV ) , _elevation ( V0 , 0.0 ) ) )
give me the cities in usa ?	_answer ( NV , ( _city ( V0 ) , _loc ( V0 , NV ) , _const ( V0 , _countryid ( usa ) ) ) )
how many states does the missouri river run through ?	_answer ( NV , _count ( NV , ( _state ( V0 ) , _const ( NV , _riverid ( missouri ) ) , _river ( V0 ) , _traverse ( V0 , V1 ) ) , V2 ) )
what state has the city with the largest population ?	_answer ( NV , ( _state ( V0 ) , _loc ( NV , V1 ) , _largest ( NV , ( _city ( V1 ) , _population ( V1 , V0 ) ) ) ) )
which is the shortest river ?	_answer ( NV , _shortest ( V0 , _river ( V0 ) ) )
how many states border alaska ?	_answer ( NV , _count ( NV , ( _state ( V0 ) , _next_to ( V0 , NV ) , _const ( V0 , _stateid ( alaska ) ) ) , V2 ) )
what is the population of dallas ?	_answer ( NV , ( _population ( NV , V1 ) , _const ( V0 , _cityid ( dallas , _ ) ) ) )
where is san jose ?	_answer ( NV , ( _loc ( NV , V1 ) , _const ( V0 , _cityid ( ' san jose ' , _ ) ) ) )
what states border states that border colorado ?	_answer ( NV , ( _state ( V0 ) , _next_to ( V0 , NV ) , _state ( V0 ) , _next_to ( V0 , NV ) , _const ( V0 , _stateid ( colorado ) ) ) )
what rivers flow through the state with the largest population ?	_answer ( NV , ( _river ( V0 ) , _traverse ( V0 , NV ) , _largest ( NV , ( _state ( V1 ) , _population ( V1 , V0 ) ) ) ) )
whats the largest city ?	_answer ( NV , _largest ( V0 , _city ( V0 ) ) )
what is the capital of the alabama state ?	_answer ( NV , ( _capital ( V0 ) , _loc ( V0 , NV ) , _const ( V0 , _stateid ( alabama ) ) , _state ( V0 ) ) )
what states border arkansas ?	_answer ( NV , ( _state ( V0 ) , _next_to ( V0 , NV ) , _const ( V0 , _stateid ( arkansas ) ) ) )
what is the population of denver ?	_answer ( NV , ( _population ( NV , V1 ) , _const ( V0 , _cityid ( denver , _ ) ) ) )
what is the longest river in america ?	_answer ( NV , _longest ( V0 , ( _river ( V0 ) , _loc ( V0 , NV ) , _const ( V0 , _countryid ( usa ) ) ) ) )
where is massachusetts ?	_answer ( NV , ( _loc ( NV , V1 ) , _const ( V0 , _stateid ( massachusetts ) ) ) )
what state has the smallest area ?	_answer ( NV , _smallest ( NV , ( _state ( V1 ) , _area ( V1 , V0 ) ) ) )
what major rivers run through illinois ?	_answer ( NV , ( _major ( V0 ) , _river ( V0 ) , _traverse ( V0 , NV ) , _const ( V0 , _stateid ( illinois ) ) ) )
how many cities does the usa have ?	_answer ( NV , _count ( NV , ( _city ( V0 ) , _const ( NV , _countryid ( usa ) ) , _loc ( V1 , V0 ) ) , V2 ) )
how many people live in california ?	_answer ( NV , ( _population ( NV , V1 ) , _const ( V0 , _stateid ( california ) ) ) )
what are the major rivers in the us ?	_answer ( NV , ( _major ( V0 ) , _river ( V0 ) , _loc ( V0 , NV ) , _const ( V0 , _countryid ( usa ) ) ) )
how many states does the mississippi river run through ?	_answer ( NV , _count ( NV , ( _state ( V0 ) , _const ( NV , _riverid ( mississippi ) ) , _river ( V0 ) , _traverse ( V0 , V1 ) ) , V2 ) )
what is the area of texas ?	_answer ( NV , ( _area ( NV , V1 ) , _const ( V0 , _stateid ( texas ) ) ) )
what is the length of the river that traverses the most states ?	_answer ( NV , ( _len ( NV , V1 ) , _most ( V0 , NV , ( _river ( V1 ) , _traverse ( V1 , V0 ) , _state ( V0 ) ) ) ) )
what is the length of the longest river in the usa ?	_answer ( NV , ( _len ( NV , V1 ) , _longest ( V0 , ( _river ( V0 ) , _loc ( V0 , NV ) , _const ( V0 , _countryid ( usa ) ) ) ) ) )
can you tell me the capital of texas ?	_answer ( NV , ( _capital ( V0 ) , _loc ( V0 , NV ) , _const ( V0 , _stateid ( texas ) ) ) )
what is the largest city in minnesota by population ?	_answer ( NV , _largest ( NV , ( _city ( V1 ) , _loc ( V1 , NV ) , _const ( V0 , _stateid ( minnesota ) ) , _population ( V2 , V1 ) ) ) )
what is the smallest state in the usa ?	_answer ( NV , _smallest ( V0 , ( _state ( V0 ) , _loc ( V0 , NV ) , _const ( V0 , _countryid ( usa ) ) ) ) )
what states neighbor maine ?	_answer ( NV , ( _state ( V0 ) , _next_to ( V0 , NV ) , _const ( V0 , _stateid ( maine ) ) ) )
what states high point are higher than that of colorado ?	_answer ( NV , ( _state ( V0 ) , _high_point ( V0 , NV ) , _higher ( V0 , NV ) , _high_point ( NV , V1 ) , _const ( V0 , _stateid ( colorado ) ) ) )
what is the highest mountain in texas ?	_answer ( NV , _highest ( V0 , ( _mountain ( V0 ) , _loc ( V0 , NV ) , _const ( V0 , _stateid ( texas ) ) ) ) )
what are the major cities in texas ?	_answer ( NV , ( _major ( V0 ) , _city ( V0 ) , _loc ( V0 , NV ) , _const ( V0 , _stateid ( texas ) ) ) )
what are the states that border the state with the greatest population ?	_answer ( NV , ( _state ( V0 ) , _next_to ( NV , V1 ) , _largest ( NV , ( _state ( V1 ) , _population ( V1 , V0 ) ) ) ) )
what rivers run through colorado ?	_answer ( NV , ( _river ( V0 ) , _traverse ( V0 , NV ) , _const ( V0 , _stateid ( colorado ) ) ) )
how many rivers are there in us ?	_answer ( NV , _count ( NV , ( _river ( V0 ) , _loc ( V0 , NV ) , _const ( V0 , _countryid ( usa ) ) ) , V2 ) )
how many rivers are in new york ?	_answer ( NV , _count ( NV , ( _river ( V0 ) , _loc ( V0 , NV ) , _const ( V0 , _stateid ( ' new york ' ) ) ) , V2 ) )
which rivers are in alaska ?	_answer ( NV , ( _river ( V0 ) , _loc ( V0 , NV ) , _const ( V0 , _stateid ( alaska ) ) ) )
what is the longest river flowing through new york ?	_answer ( NV , _longest ( V0 , ( _river ( V0 ) , _traverse ( V0 , NV ) , _const ( V0 , _stateid ( ' new york ' ) ) ) ) )
what rivers run through west virginia ?	_answer ( NV , ( _river ( V0 ) , _traverse ( V0 , NV ) , _const ( V0 , _stateid ( ' west virginia ' ) ) ) )
what are the capitals of the states that border texas ?	_answer ( NV , ( _capital ( V0 ) , _loc ( V0 , NV ) , _state ( V0 ) , _next_to ( V0 , NV ) , _const ( V0 , _stateid ( texas ) ) ) )
what is the area of california ?	_answer ( NV , ( _area ( NV , V1 ) , _const ( V0 , _stateid ( california ) ) ) )
how many states have a city named springfield ?	_answer ( NV , _count ( NV , ( _state ( V0 ) , _loc ( NV , V1 ) , _const ( V0 , _cityid ( springfield , _ ) ) ) , V2 ) )
what is the biggest city in texas ?	_answer ( NV , _largest ( V0 , ( _city ( V0 ) , _loc ( V0 , NV ) , _const ( V0 , _stateid ( texas ) ) ) ) )
how many cities named austin are there in the usa ?	_answer ( NV , _count ( NV , ( _city ( V0 ) , _const ( V0 , _cityid ( austin , _ ) ) , _loc ( V0 , NV ) , _const ( V0 , _countryid ( usa ) ) ) , V2 ) )
what are the major cities in the largest state ?	_answer ( NV , ( _major ( V0 ) , _city ( V0 ) , _loc ( V0 , NV ) , _largest ( V0 , _state ( V0 ) ) ) )
which states does the colorado river run through ?	_answer ( NV , ( _state ( V0 ) , _const ( NV , _riverid ( colorado ) ) , _traverse ( V0 , V1 ) ) )
what is the largest city in wisconsin ?	_answer ( NV , _largest ( V0 , ( _city ( V0 ) , _loc ( V0 , NV ) , _const ( V0 , _stateid ( wisconsin ) ) ) ) )
how big is alaska ?	_answer ( NV , ( _size ( NV , V1 ) , _const ( V0 , _stateid ( alaska ) ) ) )
what state contains the highest point in the us ?	_answer ( NV , ( _state ( V0 ) , _loc ( NV , V1 ) , _highest ( V0 , ( _place ( V0 ) , _loc ( V0 , NV ) , _const ( V0 , _countryid ( usa ) ) ) ) ) )
how big is north dakota ?	_answer ( NV , ( _size ( NV , V1 ) , _const ( V0 , _stateid ( ' north dakota ' ) ) ) )
which rivers flow through alaska ?	_answer ( NV , ( _river ( V0 ) , _traverse ( V0 , NV ) , _const ( V0 , _stateid ( alaska ) ) ) )
what is the highest point in the us ?	_answer ( NV , _highest ( V0 , ( _place ( V0 ) , _loc ( V0 , NV ) , _const ( V0 , _countryid ( usa ) ) ) ) )
what is the shortest river in texas ?	_answer ( NV , _shortest ( V0 , ( _river ( V0 ) , _loc ( V0 , NV ) , _const ( V0 , _stateid ( texas ) ) ) ) )
what are the major cities in the states through which the major river in virginia runs ?	_answer ( NV , ( _major ( V0 ) , _city ( V0 ) , _loc ( V0 , NV ) , _state ( V0 ) , _river ( NV ) , _loc ( V0 , NV ) , _const ( V0 , _stateid ( virginia ) ) , _traverse ( V1 , V2 ) ) )
what rivers are in oregon ?	_answer ( NV , ( _river ( V0 ) , _loc ( V0 , NV ) , _const ( V0 , _stateid ( oregon ) ) ) )
what is the lowest point in the united states ?	_answer ( NV , _lowest ( V0 , ( _place ( V0 ) , _loc ( V0 , NV ) , _const ( V0 , _countryid ( usa ) ) ) ) )
how many states have cities or towns named springfield ?	_answer ( NV , _count ( NV , ( _state ( V0 ) , _loc ( NV , V1 ) , _city ( V0 ) , _const ( V0 , _cityid ( springfield , _ ) ) ) , V2 ) )
what is the population of south dakota ?	_answer ( NV , ( _population ( NV , V1 ) , _const ( V0 , _stateid ( ' south dakota ' ) ) ) )
what is the capital of the state with the highest point ?	_answer ( NV , ( _capital ( V0 ) , _loc ( V0 , NV ) , _highest ( NV , ( _state ( V1 ) , _loc ( V0 , V1 ) , _place ( V0 ) ) ) ) )
what state has the highest elevation ?	_answer ( NV , _highest ( NV , ( _state ( V1 ) , _loc ( V0 , V1 ) , _place ( V0 ) ) ) )
what states are next to texas ?	_answer ( NV , ( _state ( V0 ) , _next_to ( V0 , NV ) , _const ( V0 , _stateid ( texas ) ) ) )
what is the longest river that passes the states that border the state that borders the most states ?	_answer ( NV , _longest ( V0 , ( _river ( V0 ) , _traverse ( V0 , NV ) , _state ( V0 ) , _next_to ( V0 , NV ) , _most ( V0 , NV , ( _state ( V1 ) , _next_to ( V1 , V0 ) , _state ( V0 ) ) ) ) ) )
which states border hawaii ?	_answer ( NV , ( _state ( V0 ) , _next_to ( V0 , NV ) , _const ( V0 , _stateid ( hawaii ) ) ) )
how many major cities are there in oregon ?	_answer ( NV , _count ( NV , ( _major ( V0 ) , _city ( V0 ) , _loc ( V0 , NV ) , _const ( V0 , _stateid ( oregon ) ) ) , V2 ) )
what is the population of springfield south dakota ?	_answer ( NV , ( _population ( NV , V1 ) , _const ( V0 , _cityid ( springfield , sd ) ) ) )
how many rivers run through texas ?	_answer ( NV , _count ( NV , ( _river ( V0 ) , _traverse ( V0 , NV ) , _const ( V0 , _stateid ( texas ) ) ) , V2 ) )
what state has the most major rivers running through it ?	_answer ( NV , _most ( V0 , NV , ( _state ( V1 ) , _loc ( V0 , V1 ) , _major ( V0 ) , _river ( V0 ) , _traverse ( V0 , V1 ) ) ) )
what are the lakes in states bordering texas ?	_answer ( NV , ( _lake ( V0 ) , _loc ( V0 , NV ) , _state ( V0 ) , _next_to ( V0 , NV ) , _const ( V0 , _stateid ( texas ) ) ) )
people in boulder ?	_answer ( NV , ( _population ( NV , V1 ) , _const ( V0 , _cityid ( boulder , _ ) ) ) )
what rivers are in nevada ?	_answer ( NV , ( _river ( V0 ) , _loc ( V0 , NV ) , _const ( V0 , _stateid ( nevada ) ) ) )
where is fort wayne ?	_answer ( NV , ( _loc ( NV , V1 ) , _const ( V0 , _cityid ( ' fort wayne ' , _ ) ) ) )
where is indianapolis ?	_answer ( NV , ( _loc ( NV , V1 ) , _const ( V0 , _cityid ( indianapolis , _ ) ) ) )
what states border states that border states that border states that border texas ?	_answer ( NV , ( _state ( V0 ) , _next_to ( V0 , NV ) , _state ( V0 ) , _next_to ( V0 , NV ) , _state ( V0 ) , _next_to ( V0 , NV ) , _state ( V0 ) , _next_to ( V0 , NV ) , _const ( V0 , _stateid ( texas ) ) ) )
population of boulder ?	_answer ( NV , ( _population ( NV , V1 ) , _const ( V0 , _cityid ( boulder , _ ) ) ) )
what are the major cities of the united states ?	_answer ( NV , ( _major ( V0 ) , _city ( V0 ) , _loc ( V0 , NV ) , _const ( V0 , _countryid ( usa ) ) ) )
show major cities in colorado ?	_answer ( NV , ( _major ( V0 ) , _city ( V0 ) , _loc ( V0 , NV ) , _const ( V0 , _stateid ( colorado ) ) ) )
what state is columbus the capital of ?	_answer ( NV , ( _state ( V0 ) , _const ( NV , _cityid ( columbus , _ ) ) , _capital ( V0 ) , _loc ( V0 , V1 ) ) )
what is the area of all the states combined ?	_answer ( NV , _sum ( NV , _state ( V0 ) , _area ( V0 ) , V1 ) )
what is the average population per square km in the us ?	_answer ( NV , ( _density ( NV , V1 ) , _const ( V0 , _countryid ( usa ) ) ) )
what is the largest state that borders california ?	_answer ( NV , _largest ( V0 , ( _state ( V0 ) , _next_to ( V0 , NV ) , _const ( V0 , _stateid ( california ) ) ) ) )
what is the population of montana ?	_answer ( NV , ( _population ( NV , V1 ) , _const ( V0 , _stateid ( montana ) ) ) )
what are the populations of all the major cities in montana ?	_answer ( NV , ( _population ( NV , V1 ) , _major ( V0 ) , _city ( V0 ) , _loc ( V0 , NV ) , _const ( V0 , _stateid ( montana ) ) ) )
which rivers run through the state with the lowest elevation in the usa ?	_answer ( NV , ( _river ( V0 ) , _traverse ( V0 , NV ) , _state ( V0 ) , _loc ( NV , V1 ) , _lowest ( V0 , ( _place ( V0 ) , _loc ( V0 , NV ) , _const ( V0 , _countryid ( usa ) ) ) ) ) )
what rivers flow through the largest state ?	_answer ( NV , ( _river ( V0 ) , _traverse ( V0 , NV ) , _largest ( V0 , _state ( V0 ) ) ) )
what is the area of maine ?	_answer ( NV , ( _area ( NV , V1 ) , _const ( V0 , _stateid ( maine ) ) ) )
what are major rivers in texas ?	_answer ( NV , ( _major ( V0 ) , _river ( V0 ) , _loc ( V0 , NV ) , _const ( V0 , _stateid ( texas ) ) ) )
what is the population density of the state with the smallest population ?	_answer ( NV , ( _density ( NV , V1 ) , _smallest ( NV , ( _state ( V1 ) , _population ( V1 , V0 ) ) ) ) )
what is the highest point in wyoming ?	_answer ( NV , _highest ( V0 , ( _place ( V0 ) , _loc ( V0 , NV ) , _const ( V0 , _stateid ( wyoming ) ) ) ) )
what states border delaware ?	_answer ( NV , ( _state ( V0 ) , _next_to ( V0 , NV ) , _const ( V0 , _stateid ( delaware ) ) ) )
which state has the most rivers running through it ?	_answer ( NV , _most ( V0 , NV , ( _state ( V1 ) , _loc ( V0 , V1 ) , _river ( V0 ) , _traverse ( V0 , V1 ) ) ) )
what is largest capital ?	_answer ( NV , _largest ( V0 , _capital ( V0 ) ) )
what is the state with the largest population density ?	_answer ( NV , _largest ( NV , ( _state ( V1 ) , _density ( V1 , V0 ) ) ) )
what states have towns named springfield ?	_answer ( NV , ( _state ( V0 ) , _loc ( NV , V1 ) , _const ( V0 , _cityid ( springfield , _ ) ) ) )
what is the smallest city in the largest state ?	_answer ( NV , _smallest ( V0 , ( _city ( V0 ) , _loc ( V0 , NV ) , _largest ( V0 , _state ( V0 ) ) ) ) )
what mountains are in alaska ?	_answer ( NV , ( _mountain ( V0 ) , _loc ( V0 , NV ) , _const ( V0 , _stateid ( alaska ) ) ) )
what rivers flow through colorado ?	_answer ( NV , ( _river ( V0 ) , _traverse ( V0 , NV ) , _const ( V0 , _stateid ( colorado ) ) ) )
which state has the least population density ?	_answer ( NV , _smallest ( NV , ( _state ( V1 ) , _density ( V1 , V0 ) ) ) )
how many inhabitants does montgomery have ?	_answer ( NV , ( _population ( NV , V1 ) , _const ( V0 , _cityid ( montgomery , _ ) ) ) )
what city has the largest population ?	_answer ( NV , _largest ( NV , ( _city ( V1 ) , _population ( V1 , V0 ) ) ) )
what is the largest state ?	_answer ( NV , _largest ( V0 , _state ( V0 ) ) )
of the states washed by the mississippi river which has the lowest point ?	_answer ( NV , _lowest ( NV , ( _state ( V1 ) , _traverse ( NV , V2 ) , _const ( V0 , _riverid ( mississippi ) ) , _loc ( V1 , V2 ) , _place ( V1 ) ) ) )
what is the area of the state with the smallest population density ?	_answer ( NV , ( _area ( NV , V1 ) , _smallest ( NV , ( _state ( V1 ) , _density ( V1 , V0 ) ) ) ) )
which state contains most rivers ?	_answer ( NV , _most ( V0 , NV , ( _state ( V1 ) , _loc ( V0 , V1 ) , _river ( V0 ) ) ) )
what is the longest river in mississippi ?	_answer ( NV , _longest ( V0 , ( _river ( V0 ) , _loc ( V0 , NV ) , _const ( V0 , _stateid ( mississippi ) ) ) ) )
what is the capital of the largest state ?	_answer ( NV , ( _capital ( V0 ) , _loc ( V0 , NV ) , _largest ( V0 , _state ( V0 ) ) ) )
what state has the largest population ?	_answer ( NV , _largest ( NV , ( _state ( V1 ) , _population ( V1 , V0 ) ) ) )
name the rivers in arkansas ?	_answer ( NV , ( _river ( V0 ) , _loc ( V0 , NV ) , _const ( V0 , _stateid ( arkansas ) ) ) )
what are the populations of states through which the mississippi run ?	_answer ( NV , ( _population ( NV , V1 ) , _state ( V0 ) , _const ( NV , _riverid ( mississippi ) ) , _traverse ( V0 , V1 ) ) )
what is the population of arizona ?	_answer ( NV , ( _population ( NV , V1 ) , _const ( V0 , _stateid ( arizona ) ) ) )
what state borders the state with the smallest population ?	_answer ( NV , ( _state ( V0 ) , _next_to ( V0 , NV ) , _smallest ( NV , ( _state ( V1 ) , _population ( V1 , V0 ) ) ) ) )
what is the total area of the usa ?	_answer ( NV , ( _area ( NV , V1 ) , _const ( V0 , _countryid ( usa ) ) ) )
what is the population of seattle washington ?	_answer ( NV , ( _population ( NV , V1 ) , _const ( V0 , _cityid ( seattle , wa ) ) ) )
what is the size of the largest state in the usa ?	_answer ( NV , ( _size ( NV , V1 ) , _largest ( V0 , ( _state ( V0 ) , _loc ( V0 , NV ) , _const ( V0 , _countryid ( usa ) ) ) ) ) )
what state has the capital salem ?	_answer ( NV , ( _state ( V0 ) , _loc ( NV , V1 ) , _capital ( V0 ) , _const ( V0 , _cityid ( salem , _ ) ) ) )
which is the lowest point of the states that the mississippi runs through ?	_answer ( NV , _lowest ( V0 , ( _place ( V0 ) , _loc ( V0 , NV ) , _state ( V0 ) , _const ( NV , _riverid ( mississippi ) ) , _traverse ( V0 , V1 ) ) ) )
how many major cities are in texas ?	_answer ( NV , _count ( NV , ( _major ( V0 ) , _city ( V0 ) , _loc ( V0 , NV ) , _const ( V0 , _stateid ( texas ) ) ) , V2 ) )
what is the capital city of the largest state in the us ?	_answer ( NV , ( _capital ( V0 ) , _city ( V0 ) , _loc ( V0 , NV ) , _largest ( V0 , ( _state ( V0 ) , _loc ( V0 , NV ) , _const ( V0 , _countryid ( usa ) ) ) ) ) )
what are the major cities in rhode island ?	_answer ( NV , ( _major ( V0 ) , _city ( V0 ) , _loc ( V0 , NV ) , _const ( V0 , _stateid ( ' rhode island ' ) ) ) )
what state has the most people ?	_answer ( NV , _largest ( NV , ( _state ( V1 ) , _population ( V1 , V0 ) ) ) )
what is the largest city of kansas ?	_answer ( NV , _largest ( V0 , ( _city ( V0 ) , _loc ( V0 , NV ) , _const ( V0 , _stateid ( kansas ) ) ) ) )
what is the area of the state with the capital albany ?	_answer ( NV , ( _area ( NV , V1 ) , _state ( V0 ) , _loc ( NV , V1 ) , _capital ( V0 ) , _const ( V0 , _cityid ( albany , _ ) ) ) )
what is the longest river that flows through colorado ?	_answer ( NV , _longest ( V0 , ( _river ( V0 ) , _traverse ( V0 , NV ) , _const ( V0 , _stateid ( colorado ) ) ) ) )
how many rivers does alaska have ?	_answer ( NV , _count ( NV , ( _river ( V0 ) , _const ( NV , _stateid ( alaska ) ) , _loc ( V1 , V0 ) ) , V2 ) )
how big is massachusetts ?	_answer ( NV , ( _size ( NV , V1 ) , _const ( V0 , _stateid ( massachusetts ) ) ) )
how large is the largest city in alaska ?	_answer ( NV , ( _size ( NV , V1 ) , _largest ( V0 , ( _city ( V0 ) , _loc ( V0 , NV ) , _const ( V0 , _stateid ( alaska ) ) ) ) ) )
how many cities are there in usa ?	_answer ( NV , _count ( NV , ( _city ( V0 ) , _loc ( V0 , NV ) , _const ( V0 , _countryid ( usa ) ) ) , V2 ) )
what states capital is dover ?	_answer ( NV , ( _state ( V0 ) , _capital ( V0 , NV ) , _const ( V0 , _cityid ( dover , _ ) ) ) )
what states border new hampshire ?	_answer ( NV , ( _state ( V0 ) , _next_to ( V0 , NV ) , _const ( V0 , _stateid ( ' new hampshire ' ) ) ) )
what is the shortest river in nebraska ?	_answer ( NV , _shortest ( V0 , ( _river ( V0 ) , _loc ( V0 , NV ) , _const ( V0 , _stateid ( nebraska ) ) ) ) )
how many states border hawaii ?	_answer ( NV , _count ( NV , ( _state ( V0 ) , _next_to ( V0 , NV ) , _const ( V0 , _stateid ( hawaii ) ) ) , V2 ) )
what state is dallas in ?	_answer ( NV , ( _state ( V0 ) , _const ( NV , _cityid ( dallas , _ ) ) , _loc ( V0 , V1 ) ) )
what city has the least population ?	_answer ( NV , _smallest ( NV , ( _city ( V1 ) , _population ( V1 , V0 ) ) ) )
how many people stay in utah ?	_answer ( NV , ( _population ( NV , V1 ) , _const ( V0 , _stateid ( utah ) ) ) )
what state has the sparsest population density ?	_answer ( NV , _smallest ( NV , ( _state ( V1 ) , _density ( V1 , V0 ) ) ) )
what is the largest state that borders the state with the lowest point in the usa ?	_answer ( NV , _largest ( V0 , ( _state ( V0 ) , _next_to ( V0 , NV ) , _state ( V0 ) , _loc ( NV , V1 ) , _lowest ( V0 , ( _place ( V0 ) , _loc ( V0 , NV ) , _const ( V0 , _countryid ( usa ) ) ) ) ) ) )
what is the largest city in texas ?	_answer ( NV , _largest ( V0 , ( _city ( V0 ) , _loc ( V0 , NV ) , _const ( V0 , _stateid ( texas ) ) ) ) )
what is the largest state in the us ?	_answer ( NV , _largest ( V0 , ( _state ( V0 ) , _loc ( V0 , NV ) , _const ( V0 , _countryid ( usa ) ) ) ) )
which state has the most people ?	_answer ( NV , _largest ( NV , ( _state ( V1 ) , _population ( V1 , V0 ) ) ) )
what rivers are in new mexico ?	_answer ( NV , ( _river ( V0 ) , _loc ( V0 , NV ) , _const ( V0 , _stateid ( ' new mexico ' ) ) ) )
what is the area of maryland in square kilometers ?	_answer ( NV , ( _area ( NV , V1 ) , _const ( V0 , _stateid ( maryland ) ) ) )
how many states are there in united states ?	_answer ( NV , _count ( NV , ( _state ( V0 ) , _loc ( V0 , NV ) , _const ( V0 , _countryid ( usa ) ) ) , V2 ) )
how many major cities are in states bordering nebraska ?	_answer ( NV , _count ( NV , ( _major ( V0 ) , _city ( V0 ) , _loc ( V0 , NV ) , _state ( V0 ) , _next_to ( V0 , NV ) , _const ( V0 , _stateid ( nebraska ) ) ) , V3 ) )
what is the population of the largest state ?	_answer ( NV , ( _population ( NV , V1 ) , _largest ( V0 , _state ( V0 ) ) ) )
what is the size of florida ?	_answer ( NV , ( _size ( NV , V1 ) , _const ( V0 , _stateid ( florida ) ) ) )
how many rivers are in missouri ?	_answer ( NV , _count ( NV , ( _river ( V0 ) , _loc ( V0 , NV ) , _const ( V0 , _stateid ( missouri ) ) ) , V2 ) )
how many rivers are there in texas ?	_answer ( NV , _count ( NV , ( _river ( V0 ) , _loc ( V0 , NV ) , _const ( V0 , _stateid ( texas ) ) ) , V2 ) )
what is the highest point in the state with the capital des moines ?	_answer ( NV , _highest ( V0 , ( _place ( V0 ) , _loc ( V0 , NV ) , _state ( V0 ) , _loc ( NV , V1 ) , _capital ( V0 ) , _const ( V0 , _cityid ( ' des moines ' , _ ) ) ) ) )
what is the population of seattle ?	_answer ( NV , ( _population ( NV , V1 ) , _const ( V0 , _cityid ( seattle , _ ) ) ) )
what is the highest point in colorado ?	_answer ( NV , _highest ( V0 , ( _place ( V0 ) , _loc ( V0 , NV ) , _const ( V0 , _stateid ( colorado ) ) ) ) )
which states border arizona ?	_answer ( NV , ( _state ( V0 ) , _next_to ( V0 , NV ) , _const ( V0 , _stateid ( arizona ) ) ) )
what rivers run through the state with the lowest point in the usa ?	_answer ( NV , ( _river ( V0 ) , _traverse ( V0 , NV ) , _state ( V0 ) , _loc ( NV , V1 ) , _lowest ( V0 , ( _place ( V0 ) , _loc ( V0 , NV ) , _const ( V0 , _countryid ( usa ) ) ) ) ) )
what is the population of minnesota ?	_answer ( NV , ( _population ( NV , V1 ) , _const ( V0 , _stateid ( minnesota ) ) ) )
what state has the city with the most population ?	_answer ( NV , ( _state ( V0 ) , _loc ( NV , V1 ) , _largest ( NV , ( _city ( V1 ) , _population ( V1 , V0 ) ) ) ) )
which states have a major city named austin ?	_answer ( NV , ( _state ( V0 ) , _loc ( NV , V1 ) , _major ( V0 ) , _city ( V0 ) , _const ( V0 , _cityid ( austin , _ ) ) ) )
which states have points higher than the highest point in colorado ?	_answer ( NV , ( _state ( V0 ) , _loc ( NV , V1 ) , _place ( V0 ) , _higher ( V0 , NV ) , _highest ( V0 , ( _place ( V0 ) , _loc ( V0 , NV ) , _const ( V0 , _stateid ( colorado ) ) ) ) ) )
what is the highest point in the state with the smallest population ?	_answer ( NV , _highest ( V0 , ( _place ( V0 ) , _loc ( V0 , NV ) , _smallest ( NV , ( _state ( V1 ) , _population ( V1 , V0 ) ) ) ) ) )
where is new hampshire ?	_answer ( NV , ( _loc ( NV , V1 ) , _const ( V0 , _stateid ( ' new hampshire ' ) ) ) )
which state borders florida ?	_answer ( NV , ( _state ( V0 ) , _next_to ( V0 , NV ) , _const ( V0 , _stateid ( florida ) ) ) )
how many rivers in texas are longer than the red ?	_answer ( NV , _count ( NV , ( _river ( V0 ) , _loc ( V0 , NV ) , _const ( V0 , _stateid ( texas ) ) , _longer ( V1 , NV ) , _const ( V0 , _riverid ( red ) ) ) , V3 ) )
how many rivers do not traverse the state with the capital albany ?	_answer ( NV , _count ( NV , ( _river ( V0 ) , \+ ( _traverse ( V0 , NV ) , _state ( V0 ) , _loc ( NV , V1 ) , _capital ( V0 ) , _const ( V0 , _cityid ( albany , _ ) ) ) ) , V3 ) )
what are the populations of the states through which the mississippi run ?	_answer ( NV , ( _population ( NV , V1 ) , _state ( V0 ) , _const ( NV , _riverid ( mississippi ) ) , _traverse ( V0 , V1 ) ) )
through which states does the mississippi run ?	_answer ( NV , ( _state ( V0 ) , _const ( NV , _riverid ( mississippi ) ) , _traverse ( V0 , V1 ) ) )
what states are next to the mississippi ?	_answer ( NV , ( _state ( V0 ) , _next_to ( V0 , NV ) , _const ( V0 , _stateid ( mississippi ) ) ) )
give me the cities in virginia ?	_answer ( NV , ( _city ( V0 ) , _loc ( V0 , NV ) , _const ( V0 , _stateid ( virginia ) ) ) )
what are the capital cities of the states which border texas ?	_answer ( NV , ( _capital ( V0 ) , _city ( V0 ) , _loc ( V0 , NV ) , _state ( V0 ) , _next_to ( V0 , NV ) , _const ( V0 , _stateid ( texas ) ) ) )
what state that borders texas has the highest population ?	_answer ( NV , _largest ( NV , ( _state ( V1 ) , _next_to ( V1 , NV ) , _const ( V0 , _stateid ( texas ) ) , _population ( V2 , V1 ) ) ) )
what state is the state with the most rivers ?	_answer ( NV , ( _state ( V0 ) , _most ( V0 , NV , ( _state ( V1 ) , _loc ( V0 , V1 ) , _river ( V0 ) ) ) ) )
what state has the least population density ?	_answer ( NV , _smallest ( NV , ( _state ( V1 ) , _density ( V1 , V0 ) ) ) )
what are the major cities in ohio ?	_answer ( NV , ( _major ( V0 ) , _city ( V0 ) , _loc ( V0 , NV ) , _const ( V0 , _stateid ( ohio ) ) ) )
which states does the missouri river run through ?	_answer ( NV , ( _state ( V0 ) , _const ( NV , _riverid ( missouri ) ) , _river ( V0 ) , _traverse ( V0 , V1 ) ) )
what is the biggest city in arizona ?	_answer ( NV , _largest ( V0 , ( _city ( V0 ) , _loc ( V0 , NV ) , _const ( V0 , _stateid ( arizona ) ) ) ) )
how many people live in hawaii ?	_answer ( NV , ( _population ( NV , V1 ) , _const ( V0 , _stateid ( hawaii ) ) ) )
how many people live in the smallest state bordering wyoming ?	_answer ( NV , ( _population ( NV , V1 ) , _smallest ( V0 , ( _state ( V0 ) , _next_to ( V0 , NV ) , _const ( V0 , _stateid ( wyoming ) ) ) ) ) )
what is the name of the state with the lowest point ?	_answer ( NV , ( _state ( V0 ) , _loc ( NV , V1 ) , _lowest ( V0 , _place ( V0 ) ) ) )
what rivers flow through missouri ?	_answer ( NV , ( _river ( V0 ) , _traverse ( V0 , NV ) , _const ( V0 , _stateid ( missouri ) ) ) )
what is the elevation of death valley ?	_answer ( NV , ( _elevation ( NV , V1 ) , _const ( V0 , _placeid ( ' death valley ' ) ) ) )
what river flows through texas ?	_answer ( NV , ( _river ( V0 ) , _traverse ( V0 , NV ) , _const ( V0 , _stateid ( texas ) ) ) )
how high are the highest points of all the states ?	_answer ( NV , ( _elevation ( NV , V1 ) , _highest ( V0 , ( _place ( V0 ) , _loc ( V0 , NV ) , _state ( V0 ) ) ) ) )
what is the capital of new hampshire ?	_answer ( NV , ( _capital ( V0 ) , _loc ( V0 , NV ) , _const ( V0 , _stateid ( ' new hampshire ' ) ) ) )
how long is the rio grande river ?	_answer ( NV , ( _len ( NV , V1 ) , _const ( V0 , _riverid ( ' rio grande ' ) ) , _river ( V0 ) ) )
which state borders most states ?	_answer ( NV , _most ( V0 , NV , ( _state ( V1 ) , _next_to ( V1 , V0 ) , _state ( V0 ) ) ) )
how many states does missouri border ?	_answer ( NV , _count ( NV , ( _state ( V0 ) , _const ( NV , _stateid ( missouri ) ) , _next_to ( V0 , V1 ) ) , V2 ) )
where is austin ?	_answer ( NV , ( _loc ( NV , V1 ) , _const ( V0 , _cityid ( austin , _ ) ) ) )
how high is the highest point of delaware ?	_answer ( NV , ( _elevation ( NV , V1 ) , _highest ( V0 , ( _place ( V0 ) , _loc ( V0 , NV ) , _const ( V0 , _stateid ( delaware ) ) ) ) ) )
where is the highest point in montana ?	_answer ( NV , _highest ( V0 , ( _place ( V0 ) , _loc ( V0 , NV ) , _const ( V0 , _stateid ( montana ) ) ) ) )
what states border states that border the state with the largest population ?	_answer ( NV , ( _state ( V0 ) , _next_to ( V0 , NV ) , _state ( V0 ) , _next_to ( V0 , NV ) , _largest ( NV , ( _state ( V1 ) , _population ( V1 , V0 ) ) ) ) )
what is the height of the highest mountain in texas ?	_answer ( NV , ( _elevation ( NV , V1 ) , _highest ( V0 , ( _mountain ( V0 ) , _loc ( V0 , NV ) , _const ( V0 , _stateid ( texas ) ) ) ) ) )
what state has the city flint ?	_answer ( NV , ( _state ( V0 ) , _loc ( NV , V1 ) , _city ( V0 ) , _const ( V0 , _cityid ( flint , _ ) ) ) )
what is the state with the largest density in usa ?	_answer ( NV , _largest ( NV , ( _state ( V1 ) , _density ( V1 , V0 ) , _loc ( V1 , NV ) , _const ( V0 , _countryid ( usa ) ) ) ) )
what cities in texas have the highest number of citizens ?	_answer ( NV , _largest ( NV , ( _city ( V1 ) , _loc ( V1 , NV ) , _const ( V0 , _stateid ( texas ) ) , _population ( V2 , V1 ) ) ) )
what states border missouri ?	_answer ( NV , ( _state ( V0 ) , _next_to ( V0 , NV ) , _const ( V0 , _stateid ( missouri ) ) ) )
give me the largest state ?	_answer ( NV , _largest ( V0 , _state ( V0 ) ) )
which state has the sparsest population density ?	_answer ( NV , _smallest ( NV , ( _state ( V1 ) , _density ( V1 , V0 ) ) ) )
which states border alabama ?	_answer ( NV , ( _state ( V0 ) , _next_to ( V0 , NV ) , _const ( V0 , _stateid ( alabama ) ) ) )
what rivers flow through states that alabama borders ?	_answer ( NV , ( _river ( V0 ) , _traverse ( V0 , NV ) , _state ( V0 ) , _const ( NV , _stateid ( alabama ) ) , _next_to ( V0 , V1 ) ) )
what are the major cities in wyoming ?	_answer ( NV , ( _major ( V0 ) , _city ( V0 ) , _loc ( V0 , NV ) , _const ( V0 , _stateid ( wyoming ) ) ) )
what are the highest points of states surrounding mississippi ?	_answer ( NV , _highest ( V0 , ( _place ( V0 ) , _loc ( V0 , NV ) , _state ( V0 ) , _next_to ( V0 , NV ) , _const ( V0 , _stateid ( mississippi ) ) ) ) )
through which states does the mississippi flow ?	_answer ( NV , ( _state ( V0 ) , _const ( NV , _riverid ( mississippi ) ) , _traverse ( V0 , V1 ) ) )
where is scotts valley ?	_answer ( NV , ( _loc ( NV , V1 ) , _const ( V0 , _cityid ( ' scotts valley ' , _ ) ) ) )
what are the major lakes in united states ?	_answer ( NV , ( _major ( V0 ) , _lake ( V0 ) , _loc ( V0 , NV ) , _const ( V0 , _countryid ( usa ) ) ) )
what is the largest city in missouri ?	_answer ( NV , _largest ( V0 , ( _city ( V0 ) , _loc ( V0 , NV ) , _const ( V0 , _stateid ( missouri ) ) ) ) )
what states border alaska ?	_answer ( NV , ( _state ( V0 ) , _next_to ( V0 , NV ) , _const ( V0 , _stateid ( alaska ) ) ) )
what state has the largest city ?	_answer ( NV , _largest ( NV , ( _state ( V1 ) , _loc ( V0 , V1 ) , _city ( V0 ) ) ) )
what rivers run through maine ?	_answer ( NV , ( _river ( V0 ) , _traverse ( V0 , NV ) , _const ( V0 , _stateid ( maine ) ) ) )
give me the lakes in california ?	_answer ( NV , ( _lake ( V0 ) , _loc ( V0 , NV ) , _const ( V0 , _stateid ( california ) ) ) )
what is the combined population of all 50 states ?	_answer ( NV , _sum ( NV , _state ( V0 ) , _population ( V0 ) , V1 ) )
how high is the highest point of louisiana ?	_answer ( NV , ( _elevation ( NV , V1 ) , _highest ( V0 , ( _place ( V0 ) , _loc ( V0 , NV ) , _const ( V0 , _stateid ( louisiana ) ) ) ) ) )
what is the longest river in pennsylvania ?	_answer ( NV , _longest ( V0 , ( _river ( V0 ) , _loc ( V0 , NV ) , _const ( V0 , _stateid ( pennsylvania ) ) ) ) )
what is the capital of maryland ?	_answer ( NV , ( _capital ( V0 ) , _loc ( V0 , NV ) , _const ( V0 , _stateid ( maryland ) ) ) )
what state is the biggest ?	_answer ( NV , _largest ( V0 , _state ( V0 ) ) )
which states border iowa ?	_answer ( NV , ( _state ( V0 ) , _next_to ( V0 , NV ) , _const ( V0 , _stateid ( iowa ) ) ) )
which states border alaska ?	_answer ( NV , ( _state ( V0 ) , _next_to ( V0 , NV ) , _const ( V0 , _stateid ( alaska ) ) ) )
what is the largest state in usa ?	_answer ( NV , _largest ( V0 , ( _state ( V0 ) , _loc ( V0 , NV ) , _const ( V0 , _countryid ( usa ) ) ) ) )
what are the major cities in california ?	_answer ( NV , ( _major ( V0 ) , _city ( V0 ) , _loc ( V0 , NV ) , _const ( V0 , _stateid ( california ) ) ) )
what is the largest state traversed by the mississippi river ?	_answer ( NV , _largest ( V0 , ( _state ( V0 ) , _traverse ( NV , V1 ) , _const ( V0 , _riverid ( mississippi ) ) ) ) )
which rivers run through states bordering new mexico ?	_answer ( NV , ( _river ( V0 ) , _traverse ( V0 , NV ) , _state ( V0 ) , _next_to ( V0 , NV ) , _const ( V0 , _stateid ( ' new mexico ' ) ) ) )
what is the lowest point in the state of texas ?	_answer ( NV , _lowest ( V0 , ( _place ( V0 ) , _loc ( V0 , NV ) , _state ( V0 ) , _const ( V0 , _stateid ( texas ) ) ) ) )
what is the smallest state bordering ohio ?	_answer ( NV , _smallest ( V0 , ( _state ( V0 ) , _next_to ( V0 , NV ) , _const ( V0 , _stateid ( ohio ) ) ) ) )
how many states are next to major rivers ?	_answer ( NV , _count ( NV , ( _state ( V0 ) , _next_to ( V0 , NV ) , _major ( V0 ) , _river ( V0 ) ) , V2 ) )
what is the lowest point of the us ?	_answer ( NV , _lowest ( V0 , ( _place ( V0 ) , _loc ( V0 , NV ) , _const ( V0 , _countryid ( usa ) ) ) ) )
which state has the greatest density ?	_answer ( NV , _largest ( NV , ( _state ( V1 ) , _density ( V1 , V0 ) ) ) )
how many states border the largest state ?	_answer ( NV , _count ( NV , ( _state ( V0 ) , _next_to ( V0 , NV ) , _largest ( V0 , _state ( V0 ) ) ) , V2 ) )
what is the longest river that does not run through texas ?	_answer ( NV , _longest ( V0 , ( _river ( V0 ) , \+ ( _traverse ( V0 , NV ) , _const ( V0 , _stateid ( texas ) ) ) ) ) )
give me all the states of usa ?	_answer ( NV , ( _state ( V0 ) , _loc ( V0 , NV ) , _const ( V0 , _countryid ( usa ) ) ) )
what is the density of texas ?	_answer ( NV , ( _density ( NV , V1 ) , _const ( V0 , _stateid ( texas ) ) ) )
what is the smallest city of the smallest state in the us ?	_answer ( NV , _smallest ( V0 , ( _city ( V0 ) , _loc ( V0 , NV ) , _smallest ( V0 , ( _state ( V0 ) , _loc ( V0 , NV ) , _const ( V0 , _countryid ( usa ) ) ) ) ) ) )
what is the highest point in kansas ?	_answer ( NV , _highest ( V0 , ( _place ( V0 ) , _loc ( V0 , NV ) , _const ( V0 , _stateid ( kansas ) ) ) ) )
what is the population in boston ?	_answer ( NV , ( _population ( NV , V1 ) , _const ( V0 , _cityid ( boston , _ ) ) ) )
how many people are in the state of nevada ?	_answer ( NV , ( _population ( NV , V1 ) , _const ( V0 , _stateid ( nevada ) ) ) )
what is the population density of texas ?	_answer ( NV , ( _density ( NV , V1 ) , _const ( V0 , _stateid ( texas ) ) ) )
how many people live in washington dc ?	_answer ( NV , ( _population ( NV , V1 ) , _const ( V0 , _cityid ( washington , dc ) ) ) )
give me the cities in texas ?	_answer ( NV , ( _city ( V0 ) , _loc ( V0 , NV ) , _const ( V0 , _stateid ( texas ) ) ) )
how long is the shortest river in the usa ?	_answer ( NV , ( _len ( NV , V1 ) , _shortest ( V0 , ( _river ( V0 ) , _loc ( V0 , NV ) , _const ( V0 , _countryid ( usa ) ) ) ) ) )
how many states have major rivers ?	_answer ( NV , _count ( NV , ( _state ( V0 ) , _loc ( NV , V1 ) , _major ( V0 ) , _river ( V0 ) ) , V2 ) )
what is the population density of the smallest state ?	_answer ( NV , ( _density ( NV , V1 ) , _smallest ( V0 , _state ( V0 ) ) ) )
which states border michigan ?	_answer ( NV , ( _state ( V0 ) , _next_to ( V0 , NV ) , _const ( V0 , _stateid ( michigan ) ) ) )
what cities in texas have the highest populations ?	_answer ( NV , _largest ( NV , ( _city ( V1 ) , _loc ( V1 , NV ) , _const ( V0 , _stateid ( texas ) ) , _population ( V2 , V1 ) ) ) )
what rivers run through the states that border the state with the capital atlanta ?	_answer ( NV , ( _river ( V0 ) , _traverse ( V0 , NV ) , _state ( V0 ) , _next_to ( V0 , NV ) , _state ( V0 ) , _loc ( NV , V1 ) , _capital ( V0 ) , _const ( V0 , _cityid ( atlanta , _ ) ) ) )
what is the highest point in the country ?	_answer ( NV , _highest ( V0 , ( _place ( V0 ) , _loc ( V0 , NV ) , _const ( V0 , _countryid ( usa ) ) ) ) )
how many people live in kalamazoo ?	_answer ( NV , ( _population ( NV , V1 ) , _const ( V0 , _cityid ( kalamazoo , _ ) ) ) )
how many major cities are in florida ?	_answer ( NV , _count ( NV , ( _major ( V0 ) , _city ( V0 ) , _loc ( V0 , NV ) , _const ( V0 , _stateid ( florida ) ) ) , V2 ) )
what state has the greatest population density ?	_answer ( NV , _largest ( NV , ( _state ( V1 ) , _density ( V1 , V0 ) ) ) )
how many rivers are found in colorado ?	_answer ( NV , _count ( NV , ( _river ( V0 ) , _loc ( V0 , NV ) , _const ( V0 , _stateid ( colorado ) ) ) , V2 ) )
what is the lowest point of the state with the largest area ?	_answer ( NV , _lowest ( V0 , ( _place ( V0 ) , _loc ( V0 , NV ) , _largest ( NV , ( _state ( V1 ) , _area ( V1 , V0 ) ) ) ) ) )
what states border texas ?	_answer ( NV , ( _state ( V0 ) , _next_to ( V0 , NV ) , _const ( V0 , _stateid ( texas ) ) ) )
how many states border at least one other state ?	_answer ( NV , _count ( NV , ( _state ( V0 ) , _next_to ( V0 , NV ) , _state ( V0 ) ) , V2 ) )
which states border no other states ?	_answer ( NV , ( _state ( V0 ) , \+ ( _next_to ( V0 , NV ) , _state ( V0 ) ) ) )
what rivers run through austin texas ?	_answer ( NV , ( _river ( V0 ) , _traverse ( V0 , NV ) , _const ( V0 , _cityid ( austin , tx ) ) ) )
how many people live in new hampshire ?	_answer ( NV , ( _population ( NV , V1 ) , _const ( V0 , _stateid ( ' new hampshire ' ) ) ) )
what is the capital of indiana ?	_answer ( NV , ( _capital ( V0 ) , _loc ( V0 , NV ) , _const ( V0 , _stateid ( indiana ) ) ) )
what states border the states with the most cities ?	_answer ( NV , ( _state ( V0 ) , _next_to ( V0 , NV ) , _most ( V0 , NV , ( _state ( V1 ) , _loc ( V0 , V1 ) , _city ( V0 ) ) ) ) )
what is the area of the smallest state ?	_answer ( NV , ( _area ( NV , V1 ) , _smallest ( V0 , _state ( V0 ) ) ) )
which states border new york ?	_answer ( NV , ( _state ( V0 ) , _next_to ( V0 , NV ) , _const ( V0 , _stateid ( ' new york ' ) ) ) )
what is the population of maine ?	_answer ( NV , ( _population ( NV , V1 ) , _const ( V0 , _stateid ( maine ) ) ) )
what is the biggest city in the smallest state ?	_answer ( NV , _largest ( V0 , ( _city ( V0 ) , _loc ( V0 , NV ) , _smallest ( V0 , _state ( V0 ) ) ) ) )
what is the elevation of the highest point in the usa ?	_answer ( NV , ( _elevation ( NV , V1 ) , _highest ( V0 , ( _place ( V0 ) , _loc ( V0 , NV ) , _const ( V0 , _countryid ( usa ) ) ) ) ) )
what state borders the least states excluding alaska and excluding hawaii ?	_answer ( NV , _fewest ( V0 , NV , ( _state ( V1 ) , _next_to ( V1 , V0 ) , _state ( V0 ) , \+ _const ( V1 , _stateid ( alaska ) ) , \+ _const ( V1 , _stateid ( hawaii ) ) ) ) )
what is the highest point in new mexico ?	_answer ( NV , _highest ( V0 , ( _place ( V0 ) , _loc ( V0 , NV ) , _const ( V0 , _stateid ( ' new mexico ' ) ) ) ) )
what is the biggest state ?	_answer ( NV , _largest ( V0 , _state ( V0 ) ) )
how many people live in spokane washington ?	_answer ( NV , ( _population ( NV , V1 ) , _const ( V0 , _cityid ( spokane , wa ) ) ) )
what states does the shortest river run through ?	_answer ( NV , ( _state ( V0 ) , _shortest ( NV , _river ( V0 ) ) , _traverse ( V0 , V1 ) ) )
how long is rio grande ?	_answer ( NV , ( _len ( NV , V1 ) , _const ( V0 , _riverid ( ' rio grande ' ) ) ) )
how many people live in texas ?	_answer ( NV , ( _population ( NV , V1 ) , _const ( V0 , _stateid ( texas ) ) ) )
where is the lowest spot in iowa ?	_answer ( NV , _lowest ( V0 , ( _place ( V0 ) , _loc ( V0 , NV ) , _const ( V0 , _stateid ( iowa ) ) ) ) )
what are the populations of the states through which the mississippi river runs ?	_answer ( NV , ( _population ( NV , V1 ) , _state ( V0 ) , _const ( NV , _riverid ( mississippi ) ) , _river ( V0 ) , _traverse ( V0 , V1 ) ) )
what is the lowest point in oregon ?	_answer ( NV , _lowest ( V0 , ( _place ( V0 ) , _loc ( V0 , NV ) , _const ( V0 , _stateid ( oregon ) ) ) ) )
what is the shortest river in alaska ?	_answer ( NV , _shortest ( V0 , ( _river ( V0 ) , _loc ( V0 , NV ) , _const ( V0 , _stateid ( alaska ) ) ) ) )
how many states border the mississippi river ?	_answer ( NV , _count ( NV , ( _state ( V0 ) , _next_to ( V0 , NV ) , _const ( V0 , _riverid ( mississippi ) ) , _river ( V0 ) ) , V2 ) )
what is the most populated capital in the usa ?	_answer ( NV , _largest ( NV , ( _population ( V1 , V0 ) , _capital ( V1 ) , _loc ( V1 , NV ) , _const ( V0 , _countryid ( usa ) ) ) ) )
what is the highest point in ohio ?	_answer ( NV , _highest ( V0 , ( _place ( V0 ) , _loc ( V0 , NV ) , _const ( V0 , _stateid ( ohio ) ) ) ) )
what states border wisconsin ?	_answer ( NV , ( _state ( V0 ) , _next_to ( V0 , NV ) , _const ( V0 , _stateid ( wisconsin ) ) ) )
what states have a capital that is the highest point in the state ?	_answer ( NV , ( _state ( V0 ) , _loc ( NV , V1 ) , _capital ( V0 ) , _high_point ( V1 , V0 ) ) )
how many states border colorado and border new mexico ?	_answer ( NV , _count ( NV , ( _state ( V0 ) , _next_to ( V0 , NV ) , _const ( V0 , _stateid ( colorado ) ) , _next_to ( V1 , NV ) , _const ( V0 , _stateid ( ' new mexico ' ) ) ) , V3 ) )
what are the major cities in missouri ?	_answer ( NV , ( _major ( V0 ) , _city ( V0 ) , _loc ( V0 , NV ) , _const ( V0 , _stateid ( missouri ) ) ) )
what are the major cities of texas ?	_answer ( NV , ( _major ( V0 ) , _city ( V0 ) , _loc ( V0 , NV ) , _const ( V0 , _stateid ( texas ) ) ) )
how many rivers are called colorado ?	_answer ( NV , _count ( NV , ( _river ( V0 ) , _const ( V0 , _riverid ( colorado ) ) ) , V1 ) )
how high is the highest point in montana ?	_answer ( NV , ( _elevation ( NV , V1 ) , _highest ( V0 , ( _place ( V0 ) , _loc ( V0 , NV ) , _const ( V0 , _stateid ( montana ) ) ) ) ) )
how many states have cities named austin ?	_answer ( NV , _count ( NV , ( _state ( V0 ) , _loc ( NV , V1 ) , _city ( V0 ) , _const ( V0 , _cityid ( austin , _ ) ) ) , V2 ) )
which states does the missouri river pass through ?	_answer ( NV , ( _state ( V0 ) , _const ( NV , _riverid ( missouri ) ) , _traverse ( V0 , V1 ) ) )
what is the biggest city in the us ?	_answer ( NV , _largest ( V0 , ( _city ( V0 ) , _loc ( V0 , NV ) , _const ( V0 , _countryid ( usa ) ) ) ) )
how big is new mexico ?	_answer ( NV , ( _size ( NV , V1 ) , _const ( V0 , _stateid ( ' new mexico ' ) ) ) )
how many people live in south dakota ?	_answer ( NV , ( _population ( NV , V1 ) , _const ( V0 , _stateid ( ' south dakota ' ) ) ) )
what state is pittsburgh in ?	_answer ( NV , ( _state ( V0 ) , _const ( NV , _cityid ( pittsburgh , _ ) ) , _loc ( V0 , V1 ) ) )
what rivers run through arizona ?	_answer ( NV , ( _river ( V0 ) , _traverse ( V0 , NV ) , _const ( V0 , _stateid ( arizona ) ) ) )
how many major rivers cross ohio ?	_answer ( NV , _count ( NV , ( _major ( V0 ) , _river ( V0 ) , _traverse ( V0 , NV ) , _const ( V0 , _stateid ( ohio ) ) ) , V2 ) )
how many people in boulder ?	_answer ( NV , ( _population ( NV , V1 ) , _const ( V0 , _cityid ( boulder , _ ) ) ) )
how many rivers are there in idaho ?	_answer ( NV , _count ( NV , ( _river ( V0 ) , _loc ( V0 , NV ) , _const ( V0 , _stateid ( idaho ) ) ) , V2 ) )
sacramento is the capital of which state ?	_answer ( NV , ( _const ( NV , _cityid ( sacramento , _ ) ) , _capital ( V0 ) , _loc ( V0 , V1 ) , _state ( V1 ) ) )
how many cities are there in us ?	_answer ( NV , _count ( NV , ( _city ( V0 ) , _loc ( V0 , NV ) , _const ( V0 , _countryid ( usa ) ) ) , V2 ) )
how many citizens live in california ?	_answer ( NV , ( _population ( NV , V1 ) , _const ( V0 , _stateid ( california ) ) ) )
what state has the largest urban population ?	_answer ( NV , _largest ( NV , ( _state ( V1 ) , _population ( V1 , V0 ) ) ) )
what states border the mississippi river ?	_answer ( NV , ( _state ( V0 ) , _next_to ( V0 , NV ) , _const ( V0 , _riverid ( mississippi ) ) , _river ( V0 ) ) )
what can you tell me about the population of missouri ?	_answer ( NV , ( _population ( NV , V1 ) , _const ( V0 , _stateid ( missouri ) ) ) )
what rivers do not run through tennessee ?	_answer ( NV , ( _river ( V0 ) , \+ ( _traverse ( V0 , NV ) , _const ( V0 , _stateid ( tennessee ) ) ) ) )
what is the largest city in a state that borders texas ?	_answer ( NV , _largest ( V0 , ( _city ( V0 ) , _loc ( V0 , NV ) , _state ( V0 ) , _next_to ( V0 , NV ) , _const ( V0 , _stateid ( texas ) ) ) ) )
name the longest river in us ?	_answer ( NV , _longest ( V0 , ( _river ( V0 ) , _loc ( V0 , NV ) , _const ( V0 , _countryid ( usa ) ) ) ) )
how many states does the mississippi run through ?	_answer ( NV , _count ( NV , ( _state ( V0 ) , _const ( NV , _riverid ( mississippi ) ) , _traverse ( V0 , V1 ) ) , V2 ) )
what is the largest of the state that the rio grande runs through ?	_answer ( NV , _largest ( V0 , ( _state ( V0 ) , _const ( NV , _riverid ( ' rio grande ' ) ) , _traverse ( V0 , V1 ) ) ) )
what is the size of the capital of texas ?	_answer ( NV , ( _size ( NV , V1 ) , _capital ( V0 ) , _loc ( V0 , NV ) , _const ( V0 , _stateid ( texas ) ) ) )
what states have rivers running through them ?	_answer ( NV , ( _state ( V0 ) , _loc ( NV , V1 ) , _river ( V0 ) , _traverse ( V0 , V1 ) ) )
what states border hawaii ?	_answer ( NV , ( _state ( V0 ) , _next_to ( V0 , NV ) , _const ( V0 , _stateid ( hawaii ) ) ) )
how many citizens in boulder ?	_answer ( NV , ( _population ( NV , V1 ) , _const ( V0 , _cityid ( boulder , _ ) ) ) )
what states border states that border states that border florida ?	_answer ( NV , ( _state ( V0 ) , _next_to ( V0 , NV ) , _state ( V0 ) , _next_to ( V0 , NV ) , _state ( V0 ) , _next_to ( V0 , NV ) , _const ( V0 , _stateid ( florida ) ) ) )
which states border the longest river in the usa ?	_answer ( NV , ( _state ( V0 ) , _next_to ( V0 , NV ) , _longest ( V0 , ( _river ( V0 ) , _loc ( V0 , NV ) , _const ( V0 , _countryid ( usa ) ) ) ) ) )
what is the population density of wyoming ?	_answer ( NV , ( _density ( NV , V1 ) , _const ( V0 , _stateid ( wyoming ) ) ) )
how many people are there in iowa ?	_answer ( NV , ( _population ( NV , V1 ) , _const ( V0 , _stateid ( iowa ) ) ) )
what is the highest point in the state with the most rivers ?	_answer ( NV , _highest ( V0 , ( _place ( V0 ) , _loc ( V0 , NV ) , _most ( V0 , NV , ( _state ( V1 ) , _traverse ( V0 , V1 ) , _river ( V0 ) ) ) ) ) )
number of citizens in boulder ?	_answer ( NV , ( _population ( NV , V1 ) , _const ( V0 , _cityid ( boulder , _ ) ) ) )
what are the rivers of montana ?	_answer ( NV , ( _river ( V0 ) , _loc ( V0 , NV ) , _const ( V0 , _stateid ( montana ) ) ) )
how many states border on the state whose capital is boston ?	_answer ( NV , _count ( NV , ( _state ( V0 ) , _next_to ( V0 , NV ) , _state ( V0 ) , _loc ( NV , V1 ) , _capital ( V0 ) , _const ( V0 , _cityid ( boston , _ ) ) ) , V3 ) )
how many people live in washington ?	_answer ( NV , ( _population ( NV , V1 ) , _const ( V0 , _stateid ( washington ) ) ) )
what is the largest state capital in population ?	_answer ( NV , _largest ( NV , ( _state ( NV ) , _capital ( V0 , V2 ) , _population ( V2 , V1 ) ) ) )
what is the largest city in states that border california ?	_answer ( NV , _largest ( V0 , ( _city ( V0 ) , _loc ( V0 , NV ) , _state ( V0 ) , _next_to ( V0 , NV ) , _const ( V0 , _stateid ( california ) ) ) ) )
what is the most populous city in wyoming ?	_answer ( NV , _largest ( NV , ( _population ( V1 , V0 ) , _city ( V1 ) , _loc ( V1 , NV ) , _const ( V0 , _stateid ( wyoming ) ) ) ) )
what is the population density in the state with capital austin ?	_answer ( NV , ( _density ( NV , V1 ) , _state ( V0 ) , _loc ( NV , V1 ) , _capital ( V0 ) , _const ( V0 , _cityid ( austin , _ ) ) ) )
what is the population of portland maine ?	_answer ( NV , ( _population ( NV , V1 ) , _const ( V0 , _cityid ( portland , me ) ) ) )
which state is kalamazoo in ?	_answer ( NV , ( _state ( V0 ) , _const ( NV , _cityid ( kalamazoo , _ ) ) , _loc ( V0 , V1 ) ) )
what is the population of the largest state that borders texas ?	_answer ( NV , ( _population ( NV , V1 ) , _largest ( V0 , ( _state ( V0 ) , _next_to ( V0 , NV ) , _const ( V0 , _stateid ( texas ) ) ) ) ) )
what states border ohio ?	_answer ( NV , ( _state ( V0 ) , _next_to ( V0 , NV ) , _const ( V0 , _stateid ( ohio ) ) ) )
what river is the longest one in the united states ?	_answer ( NV , _longest ( V0 , ( _river ( V0 ) , _loc ( V0 , NV ) , _const ( V0 , _countryid ( usa ) ) ) ) )
what is the population density of the state with the smallest area ?	_answer ( NV , ( _density ( NV , V1 ) , _smallest ( NV , ( _state ( V1 ) , _area ( V1 , V0 ) ) ) ) )
what is the largest capital ?	_answer ( NV , _largest ( V0 , _capital ( V0 ) ) )
what state has the smallest capital ?	_answer ( NV , ( _state ( V0 ) , _loc ( NV , V1 ) , _smallest ( V0 , _capital ( V0 ) ) ) )
how many big cities are in pennsylvania ?	_answer ( NV , _count ( NV , ( _major ( V0 ) , _city ( V0 ) , _loc ( V0 , NV ) , _const ( V0 , _stateid ( pennsylvania ) ) ) , V2 ) )
which states lie on the largest river in the united states ?	_answer ( NV , ( _state ( V0 ) , _traverse ( NV , V1 ) , _largest ( V0 , ( _river ( V0 ) , _loc ( V0 , NV ) , _const ( V0 , _countryid ( usa ) ) ) ) ) )
where is houston ?	_answer ( NV , ( _loc ( NV , V1 ) , _const ( V0 , _cityid ( houston , _ ) ) ) )
what rivers flow through states that border the state with the largest population ?	_answer ( NV , ( _river ( V0 ) , _traverse ( V0 , NV ) , _state ( V0 ) , _next_to ( V0 , NV ) , _largest ( NV , ( _state ( V1 ) , _population ( V1 , V0 ) ) ) ) )
what is the highest point in the smallest state ?	_answer ( NV , _highest ( V0 , ( _place ( V0 ) , _loc ( V0 , NV ) , _smallest ( V0 , _state ( V0 ) ) ) ) )
what river runs through virginia ?	_answer ( NV , ( _river ( V0 ) , _traverse ( V0 , NV ) , _const ( V0 , _stateid ( virginia ) ) ) )
what state borders michigan ?	_answer ( NV , ( _state ( V0 ) , _next_to ( V0 , NV ) , _const ( V0 , _stateid ( michigan ) ) ) )
name the major lakes in michigan ?	_answer ( NV , ( _major ( V0 ) , _lake ( V0 ) , _loc ( V0 , NV ) , _const ( V0 , _stateid ( michigan ) ) ) )
give me the cities in virginia ?	_answer ( NV , ( _city ( V0 ) , _loc ( V0 , NV ) , _const ( V0 , _stateid ( virginia ) ) ) )
which river runs through the most states ?	_answer ( NV , _most ( V0 , NV , ( _river ( V1 ) , _traverse ( V1 , V0 ) , _state ( V0 ) ) ) )
how many people live in new mexico ?	_answer ( NV , ( _population ( NV , V1 ) , _const ( V0 , _stateid ( ' new mexico ' ) ) ) )
what is the largest city in alabama ?	_answer ( NV , _largest ( V0 , ( _city ( V0 ) , _loc ( V0 , NV ) , _const ( V0 , _stateid ( alabama ) ) ) ) )
how many people live in san francisco ?	_answer ( NV , ( _population ( NV , V1 ) , _const ( V0 , _cityid ( ' san francisco ' , _ ) ) ) )
what is the population of the capital of the largest state ?	_answer ( NV , ( _population ( NV , V1 ) , _capital ( V0 ) , _loc ( V0 , NV ) , _largest ( V0 , _state ( V0 ) ) ) )
what is the longest river in the us ?	_answer ( NV , _longest ( V0 , ( _river ( V0 ) , _loc ( V0 , NV ) , _const ( V0 , _countryid ( usa ) ) ) ) )
what is the largest state that borders the state with the highest population ?	_answer ( NV , _largest ( V0 , ( _state ( V0 ) , _next_to ( V0 , NV ) , _largest ( NV , ( _state ( V1 ) , _population ( V1 , V0 ) ) ) ) ) )
show me all the major lakes in the us ?	_answer ( NV , ( _major ( V0 ) , _lake ( V0 ) , _loc ( V0 , NV ) , _const ( V0 , _countryid ( usa ) ) ) )
where is springfield ?	_answer ( NV , ( _loc ( NV , V1 ) , _const ( V0 , _cityid ( springfield , _ ) ) ) )
what state is des moines located in ?	_answer ( NV , ( _state ( V0 ) , _const ( NV , _cityid ( ' des moines ' , _ ) ) , _loc ( V0 , V1 ) ) )
how many cities does texas have ?	_answer ( NV , _count ( NV , ( _city ( V0 ) , _const ( NV , _stateid ( texas ) ) , _loc ( V1 , V0 ) ) , V2 ) )
what state is boston in ?	_answer ( NV , ( _state ( V0 ) , _const ( NV , _cityid ( boston , _ ) ) , _loc ( V0 , V1 ) ) )
which rivers run through the state with the largest city in the us ?	_answer ( NV , ( _river ( V0 ) , _traverse ( V0 , NV ) , _largest ( NV , ( _state ( V1 ) , _loc ( V0 , V1 ) , _city ( V0 ) , _loc ( V0 , NV ) , _const ( V0 , _countryid ( usa ) ) ) ) ) )
states bordering iowa ?	_answer ( NV , ( _state ( V0 ) , _next_to ( V0 , NV ) , _const ( V0 , _stateid ( iowa ) ) ) )
what states have no bordering state ?	_answer ( NV , ( _state ( V0 ) , \+ ( _next_to ( V0 , NV ) , _state ( V0 ) ) ) )
where is the lowest point in the us ?	_answer ( NV , _lowest ( V0 , ( _place ( V0 ) , _loc ( V0 , NV ) , _const ( V0 , _countryid ( usa ) ) ) ) )
what are the major cities in oklahoma ?	_answer ( NV , ( _major ( V0 ) , _city ( V0 ) , _loc ( V0 , NV ) , _const ( V0 , _stateid ( oklahoma ) ) ) )
which state has the smallest area that borders texas ?	_answer ( NV , _smallest ( NV , ( _state ( V1 ) , _area ( V1 , V0 ) , _next_to ( V1 , NV ) , _const ( V0 , _stateid ( texas ) ) ) ) )
what is the capital of the state with the highest elevation ?	_answer ( NV , ( _capital ( V0 ) , _loc ( V0 , NV ) , _state ( V0 ) , _loc ( NV , V1 ) , _highest ( V0 , _place ( V0 ) ) ) )
what states does the mississippi run through ?	_answer ( NV , ( _state ( V0 ) , _const ( NV , _riverid ( mississippi ) ) , _traverse ( V0 , V1 ) ) )
where is mount whitney located ?	_answer ( NV , ( _loc ( NV , V1 ) , _const ( V0 , _placeid ( ' mount whitney ' ) ) ) )
which state has the largest density ?	_answer ( NV , _largest ( NV , ( _state ( V1 ) , _density ( V1 , V0 ) ) ) )
what is the smallest city in washington ?	_answer ( NV , _smallest ( V0 , ( _city ( V0 ) , _loc ( V0 , NV ) , _const ( V0 , _stateid ( washington ) ) ) ) )
what are the major cities in new mexico ?	_answer ( NV , ( _major ( V0 ) , _city ( V0 ) , _loc ( V0 , NV ) , _const ( V0 , _stateid ( ' new mexico ' ) ) ) )
how many people live in the capital of georgia ?	_answer ( NV , ( _population ( NV , V1 ) , _capital ( V0 ) , _loc ( V0 , NV ) , _const ( V0 , _stateid ( georgia ) ) ) )
what state which the mississippi runs through has the largest population ?	_answer ( NV , _largest ( NV , ( _state ( V1 ) , _const ( NV , _riverid ( mississippi ) ) , _traverse ( V0 , V2 ) , _population ( V2 , V1 ) ) ) )
state the state with the largest area ?	_answer ( NV , ( _state ( V0 ) , _largest ( NV , ( _state ( V1 ) , _area ( V1 , V0 ) ) ) ) )
how many people live in riverside ?	_answer ( NV , ( _population ( NV , V1 ) , _const ( V0 , _cityid ( riverside , _ ) ) ) )
what is the area of seattle ?	_answer ( NV , ( _area ( NV , V1 ) , _const ( V0 , _cityid ( seattle , _ ) ) ) )
what capital has the largest population ?	_answer ( NV , _largest ( NV , ( _capital ( V1 ) , _population ( V1 , V0 ) ) ) )
what is the capital of the state that borders the most states ?	_answer ( NV , ( _capital ( V0 ) , _loc ( V0 , NV ) , _most ( V0 , NV , ( _state ( V1 ) , _next_to ( V1 , V0 ) , _state ( V0 ) ) ) ) )
how many rivers run through the states bordering colorado ?	_answer ( NV , _count ( NV , ( _river ( V0 ) , _traverse ( V0 , NV ) , _state ( V0 ) , _next_to ( V0 , NV ) , _const ( V0 , _stateid ( colorado ) ) ) , V3 ) )
what are the cities in california ?	_answer ( NV , ( _city ( V0 ) , _loc ( V0 , NV ) , _const ( V0 , _stateid ( california ) ) ) )
what state is austin the capital of ?	_answer ( NV , ( _state ( V0 ) , _const ( NV , _cityid ( austin , _ ) ) , _capital ( V0 ) , _loc ( V0 , V1 ) ) )
how many people live in kansas ?	_answer ( NV , ( _population ( NV , V1 ) , _const ( V0 , _stateid ( kansas ) ) ) )
what state borders the least states ?	_answer ( NV , _fewest ( V0 , NV , ( _state ( V1 ) , _next_to ( V1 , V0 ) , _state ( V0 ) ) ) )
which states border south dakota ?	_answer ( NV , ( _state ( V0 ) , _next_to ( V0 , NV ) , _const ( V0 , _stateid ( ' south dakota ' ) ) ) )
name the rivers in arkansas ?	_answer ( NV , ( _river ( V0 ) , _loc ( V0 , NV ) , _const ( V0 , _stateid ( arkansas ) ) ) )
how long is the mississippi river in miles ?	_answer ( NV , ( _len ( NV , V1 ) , _const ( V0 , _riverid ( mississippi ) ) , _river ( V0 ) ) )
what is the shortest river in the us ?	_answer ( NV , _shortest ( V0 , ( _river ( V0 ) , _loc ( V0 , NV ) , _const ( V0 , _countryid ( usa ) ) ) ) )
what is the biggest city in usa ?	_answer ( NV , _largest ( V0 , ( _city ( V0 ) , _loc ( V0 , NV ) , _const ( V0 , _countryid ( usa ) ) ) ) )
what is the capital of washington ?	_answer ( NV , ( _capital ( V0 ) , _loc ( V0 , NV ) , _const ( V0 , _stateid ( washington ) ) ) )
how many cities are in montana ?	_answer ( NV , _count ( NV , ( _city ( V0 ) , _loc ( V0 , NV ) , _const ( V0 , _stateid ( montana ) ) ) , V2 ) )
what is the capital of the state texas ?	_answer ( NV , ( _capital ( V0 ) , _loc ( V0 , NV ) , _state ( V0 ) , _const ( V0 , _stateid ( texas ) ) ) )
what is the height of mount mckinley ?	_answer ( NV , ( _elevation ( NV , V1 ) , _const ( V0 , _placeid ( ' mount mckinley ' ) ) ) )
what is the city with the smallest population ?	_answer ( NV , _smallest ( NV , ( _city ( V1 ) , _population ( V1 , V0 ) ) ) )
what is the biggest state in the usa ?	_answer ( NV , _largest ( V0 , ( _state ( V0 ) , _loc ( V0 , NV ) , _const ( V0 , _countryid ( usa ) ) ) ) )
how many major cities are in states bordering utah ?	_answer ( NV , _count ( NV , ( _major ( V0 ) , _city ( V0 ) , _loc ( V0 , NV ) , _state ( V0 ) , _next_to ( V0 , NV ) , _const ( V0 , _stateid ( utah ) ) ) , V3 ) )
how many states border tennessee ?	_answer ( NV , _count ( NV , ( _state ( V0 ) , _next_to ( V0 , NV ) , _const ( V0 , _stateid ( tennessee ) ) ) , V2 ) )
what states does the ohio river go through ?	_answer ( NV , ( _state ( V0 ) , _const ( NV , _riverid ( ohio ) ) , _river ( V0 ) , _traverse ( V0 , V1 ) ) )
what is the longest river in the smallest state in the usa ?	_answer ( NV , _longest ( V0 , ( _river ( V0 ) , _loc ( V0 , NV ) , _smallest ( V0 , ( _state ( V0 ) , _loc ( V0 , NV ) , _const ( V0 , _countryid ( usa ) ) ) ) ) ) )
what is the smallest state by area ?	_answer ( NV , _smallest ( NV , ( _state ( V1 ) , _area ( V1 , V0 ) ) ) )
what is the population of the capital of the largest state through which the mississippi runs ?	_answer ( NV , ( _population ( NV , V1 ) , _capital ( V0 ) , _loc ( V0 , NV ) , _largest ( V0 , ( _state ( V0 ) , _const ( NV , _riverid ( mississippi ) ) , _traverse ( V0 , V1 ) ) ) ) )
what is the population of boston massachusetts ?	_answer ( NV , ( _population ( NV , V1 ) , _const ( V0 , _cityid ( boston , ma ) ) ) )
what cities in california ?	_answer ( NV , ( _city ( V0 ) , _loc ( V0 , NV ) , _const ( V0 , _stateid ( california ) ) ) )
how big is the city of new york ?	_answer ( NV , ( _size ( NV , V1 ) , _const ( V0 , _cityid ( ' new york ' , _ ) ) ) )
what state has the most cities ?	_answer ( NV , _most ( V0 , NV , ( _state ( V1 ) , _loc ( V0 , V1 ) , _city ( V0 ) ) ) )
what is the longest river ?	_answer ( NV , _longest ( V0 , _river ( V0 ) ) )
name the 50 capitals in the usa ?	_answer ( NV , ( _capital ( V0 ) , _loc ( V0 , NV ) , _const ( V0 , _countryid ( usa ) ) ) )
what is the capital of the state that borders the state that borders texas ?	_answer ( NV , ( _capital ( V0 ) , _loc ( V0 , NV ) , _state ( V0 ) , _next_to ( V0 , NV ) , _state ( V0 ) , _next_to ( V0 , NV ) , _const ( V0 , _stateid ( texas ) ) ) )
which state has the red river ?	_answer ( NV , ( _state ( V0 ) , _loc ( NV , V1 ) , _const ( V0 , _riverid ( red ) ) , _river ( V0 ) ) )
how many people live in chicago ?	_answer ( NV , ( _population ( NV , V1 ) , _const ( V0 , _cityid ( chicago , _ ) ) ) )
what is the smallest city in alaska ?	_answer ( NV , _smallest ( V0 , ( _city ( V0 ) , _loc ( V0 , NV ) , _const ( V0 , _stateid ( alaska ) ) ) ) )
list the states ?	_answer ( NV , _state ( V0 ) )
what is the biggest city in georgia ?	_answer ( NV , _largest ( V0 , ( _city ( V0 ) , _loc ( V0 , NV ) , _const ( V0 , _stateid ( georgia ) ) ) ) )
what states border states which the mississippi runs through ?	_answer ( NV , ( _state ( V0 ) , _next_to ( V0 , NV ) , _state ( V0 ) , _const ( NV , _riverid ( mississippi ) ) , _traverse ( V0 , V1 ) ) )
how many cities are there in the us ?	_answer ( NV , _count ( NV , ( _city ( V0 ) , _loc ( V0 , NV ) , _const ( V0 , _countryid ( usa ) ) ) , V2 ) )
how big is texas ?	_answer ( NV , ( _size ( NV , V1 ) , _const ( V0 , _stateid ( texas ) ) ) )
what is the height of the highest point in the usa ?	_answer ( NV , ( _elevation ( NV , V1 ) , _highest ( V0 , ( _place ( V0 ) , _loc ( V0 , NV ) , _const ( V0 , _countryid ( usa ) ) ) ) ) )
what are the populations of the states through which the mississippi runs ?	_answer ( NV , ( _population ( NV , V1 ) , _state ( V0 ) , _const ( NV , _riverid ( mississippi ) ) , _traverse ( V0 , V1 ) ) )
what state has the smallest population ?	_answer ( NV , _smallest ( NV , ( _state ( V1 ) , _population ( V1 , V0 ) ) ) )
how many states border texas ?	_answer ( NV , _count ( NV , ( _state ( V0 ) , _next_to ( V0 , NV ) , _const ( V0 , _stateid ( texas ) ) ) , V2 ) )
which states do colorado river flow through ?	_answer ( NV , ( _state ( V0 ) , _const ( NV , _riverid ( colorado ) ) , _river ( V0 ) , _traverse ( V0 , V1 ) ) )
what is the highest point in texas ?	_answer ( NV , _highest ( V0 , ( _place ( V0 ) , _loc ( V0 , NV ) , _const ( V0 , _stateid ( texas ) ) ) ) )
what is the longest river in california ?	_answer ( NV , _longest ( V0 , ( _river ( V0 ) , _loc ( V0 , NV ) , _const ( V0 , _stateid ( california ) ) ) ) )
what is the length of the river that runs through the most number of states ?	_answer ( NV , ( _len ( NV , V1 ) , _most ( V0 , NV , ( _river ( V1 ) , _traverse ( V1 , V0 ) , _state ( V0 ) ) ) ) )
what is the most populous state in the us ?	_answer ( NV , _largest ( NV , ( _population ( V1 , V0 ) , _state ( V1 ) , _loc ( V1 , NV ) , _const ( V0 , _countryid ( usa ) ) ) ) )
what is the capital of georgia ?	_answer ( NV , ( _capital ( V0 ) , _loc ( V0 , NV ) , _const ( V0 , _stateid ( georgia ) ) ) )
what is the average population of the us by state ?	_answer ( NV , ( _density ( NV , V1 ) , _const ( V0 , _countryid ( usa ) ) ) )
what is the area of new mexico ?	_answer ( NV , ( _area ( NV , V1 ) , _const ( V0 , _stateid ( ' new mexico ' ) ) ) )
what is the longest river in texas ?	_answer ( NV , _longest ( V0 , ( _river ( V0 ) , _loc ( V0 , NV ) , _const ( V0 , _stateid ( texas ) ) ) ) )
how many major cities are there ?	_answer ( NV , _count ( NV , ( _major ( V0 ) , _city ( V0 ) ) , V1 ) )
how many rivers are in the state with the largest population ?	_answer ( NV , _count ( NV , ( _river ( V0 ) , _loc ( V0 , NV ) , _largest ( NV , ( _state ( V1 ) , _population ( V1 , V0 ) ) ) ) , V3 ) )
what is the major cities in montana ?	_answer ( NV , ( _major ( V0 ) , _city ( V0 ) , _loc ( V0 , NV ) , _const ( V0 , _stateid ( montana ) ) ) )
what is the population of the major cities in wisconsin ?	_answer ( NV , ( _population ( NV , V1 ) , _major ( V0 ) , _city ( V0 ) , _loc ( V0 , NV ) , _const ( V0 , _stateid ( wisconsin ) ) ) )
which states does not border texas ?	_answer ( NV , ( _state ( V0 ) , \+ ( _next_to ( V0 , NV ) , _const ( V0 , _stateid ( texas ) ) ) ) )
what river traverses the most states ?	_answer ( NV , _most ( V0 , NV , ( _river ( V1 ) , _traverse ( V1 , V0 ) , _state ( V0 ) ) ) )
what is the state with the lowest population density ?	_answer ( NV , _smallest ( NV , ( _state ( V1 ) , _density ( V1 , V0 ) ) ) )
what states does the missouri river run through ?	_answer ( NV , ( _state ( V0 ) , _const ( NV , _riverid ( missouri ) ) , _river ( V0 ) , _traverse ( V0 , V1 ) ) )
how many rivers are in colorado ?	_answer ( NV , _count ( NV , ( _river ( V0 ) , _loc ( V0 , NV ) , _const ( V0 , _stateid ( colorado ) ) ) , V2 ) )
what is the shortest river in iowa ?	_answer ( NV , _shortest ( V0 , ( _river ( V0 ) , _loc ( V0 , NV ) , _const ( V0 , _stateid ( iowa ) ) ) ) )
what states border states that the mississippi runs through ?	_answer ( NV , ( _state ( V0 ) , _next_to ( V0 , NV ) , _state ( V0 ) , _const ( NV , _riverid ( mississippi ) ) , _traverse ( V0 , V1 ) ) )
how many people are there in new york ?	_answer ( NV , ( _population ( NV , V1 ) , _const ( V0 , _stateid ( ' new york ' ) ) ) )
what is the city in texas with the largest population ?	_answer ( NV , _largest ( NV , ( _city ( V1 ) , _loc ( V1 , NV ) , _const ( V0 , _stateid ( texas ) ) , _population ( V2 , V1 ) ) ) )
what is the highest elevation in new mexico ?	_answer ( NV , _highest ( V0 , ( _place ( V0 ) , _loc ( V0 , NV ) , _const ( V0 , _stateid ( ' new mexico ' ) ) ) ) )
what is the highest point in the united states ?	_answer ( NV , _highest ( V0 , ( _place ( V0 ) , _loc ( V0 , NV ) , _const ( V0 , _countryid ( usa ) ) ) ) )
what is the population of the state with the largest area ?	_answer ( NV , ( _population ( NV , V1 ) , _largest ( NV , ( _state ( V1 ) , _area ( V1 , V0 ) ) ) ) )
where is baton rouge ?	_answer ( NV , ( _loc ( NV , V1 ) , _const ( V0 , _cityid ( ' baton rouge ' , _ ) ) ) )
what states in the united states have a city of springfield ?	_answer ( NV , ( _state ( V0 ) , _loc ( V0 , NV ) , _const ( V0 , _countryid ( usa ) ) , _loc ( NV , V2 ) , _const ( V0 , _cityid ( springfield , _ ) ) ) )
how many cities are in louisiana ?	_answer ( NV , _count ( NV , ( _city ( V0 ) , _loc ( V0 , NV ) , _const ( V0 , _stateid ( louisiana ) ) ) , V2 ) )
how many states are in the united states ?	_answer ( NV , _count ( NV , ( _state ( V0 ) , _loc ( V0 , NV ) , _const ( V0 , _countryid ( usa ) ) ) , V2 ) )
what rivers run through louisiana ?	_answer ( NV , ( _river ( V0 ) , _traverse ( V0 , NV ) , _const ( V0 , _stateid ( louisiana ) ) ) )
how many people live in the state with the largest population density ?	_answer ( NV , ( _population ( NV , V1 ) , _largest ( NV , ( _state ( V1 ) , _density ( V1 , V0 ) ) ) ) )
what is the state with the highest elevation in the united states ?	_answer ( NV , ( _state ( V0 ) , _loc ( NV , V1 ) , _highest ( V0 , ( _place ( V0 ) , _loc ( V0 , NV ) , _const ( V0 , _countryid ( usa ) ) ) ) ) )
what state borders most other states ?	_answer ( NV , _most ( V0 , NV , ( _state ( V1 ) , _next_to ( V1 , V0 ) , _state ( V0 ) ) ) )
which states adjoin alabama ?	_answer ( NV , ( _state ( V0 ) , _next_to ( V0 , NV ) , _const ( V0 , _stateid ( alabama ) ) ) )
what is the length of the colorado river in texas ?	_answer ( NV , ( _len ( NV , V1 ) , _const ( V0 , _riverid ( colorado ) ) , _river ( V0 ) , _loc ( V0 , NV ) , _const ( V0 , _stateid ( texas ) ) ) )
what state has the highest population ?	_answer ( NV , _largest ( NV , ( _state ( V1 ) , _population ( V1 , V0 ) ) ) )
what is the state that contains the highest point ?	_answer ( NV , ( _state ( V0 ) , _loc ( NV , V1 ) , _highest ( V0 , _place ( V0 ) ) ) )
what is the population density of south dakota ?	_answer ( NV , ( _density ( NV , V1 ) , _const ( V0 , _stateid ( ' south dakota ' ) ) ) )
what states have cities named austin ?	_answer ( NV , ( _state ( V0 ) , _loc ( NV , V1 ) , _city ( V0 ) , _const ( V0 , _cityid ( austin , _ ) ) ) )
how many people live in montana ?	_answer ( NV , ( _population ( NV , V1 ) , _const ( V0 , _stateid ( montana ) ) ) )
how big is the city of albany ?	_answer ( NV , ( _size ( NV , V1 ) , _const ( V0 , _cityid ( albany , _ ) ) ) )
what is the biggest river in rhode island ?	_answer ( NV , _largest ( V0 , ( _river ( V0 ) , _loc ( V0 , NV ) , _const ( V0 , _stateid ( ' rhode island ' ) ) ) ) )
what state borders arkansas ?	_answer ( NV , ( _state ( V0 ) , _next_to ( V0 , NV ) , _const ( V0 , _stateid ( arkansas ) ) ) )
how many cities named salem are there in the usa ?	_answer ( NV , _count ( NV , ( _city ( V0 ) , _const ( V0 , _cityid ( salem , _ ) ) , _loc ( V0 , NV ) , _const ( V0 , _countryid ( usa ) ) ) , V2 ) )
what is capital of missouri ?	_answer ( NV , ( _capital ( V0 ) , _loc ( V0 , NV ) , _const ( V0 , _stateid ( missouri ) ) ) )
how many citizens in albany ?	_answer ( NV , ( _population ( NV , V1 ) , _const ( V0 , _cityid ( albany , _ ) ) ) )
what is the size of maryland ?	_answer ( NV , ( _size ( NV , V1 ) , _const ( V0 , _stateid ( maryland ) ) ) )
how many inhabitants does kalamazoo have ?	_answer ( NV , ( _population ( NV , V1 ) , _const ( V0 , _cityid ( kalamazoo , _ ) ) ) )
what state which the colorado runs through has the largest population ?	_answer ( NV , _largest ( NV , ( _state ( V1 ) , _const ( NV , _riverid ( colorado ) ) , _traverse ( V0 , V2 ) , _population ( V2 , V1 ) ) ) )
which state is the largest city in colorado in ?	_answer ( NV , ( _state ( V0 ) , _largest ( NV , ( _city ( V0 ) , _loc ( V0 , NV ) , _const ( V0 , _stateid ( colorado ) ) ) ) , _loc ( V1 , V2 ) ) )
what is capital of rhode island ?	_answer ( NV , ( _capital ( V0 ) , _loc ( V0 , NV ) , _const ( V0 , _stateid ( ' rhode island ' ) ) ) )
how many people are there in california ?	_answer ( NV , ( _population ( NV , V1 ) , _const ( V0 , _stateid ( california ) ) ) )
what are the names of the major cities in kentucky ?	_answer ( NV , ( _major ( V0 ) , _city ( V0 ) , _loc ( V0 , NV ) , _const ( V0 , _stateid ( kentucky ) ) ) )
show major cities in washington ?	_answer ( NV , ( _major ( V0 ) , _city ( V0 ) , _loc ( V0 , NV ) , _const ( V0 , _stateid ( washington ) ) ) )
how many inhabitants does austin have ?	_answer ( NV , ( _population ( NV , V1 ) , _const ( V0 , _cityid ( austin , _ ) ) ) )
how many rivers are there in north dakota ?	_answer ( NV , _count ( NV , ( _river ( V0 ) , _loc ( V0 , NV ) , _const ( V0 , _stateid ( ' north dakota ' ) ) ) , V2 ) )
how many people are in the state of iowa ?	_answer ( NV , ( _population ( NV , V1 ) , _const ( V0 , _stateid ( iowa ) ) ) )
what is the smallest state bordering massachusetts ?	_answer ( NV , _smallest ( V0 , ( _state ( V0 ) , _next_to ( V0 , NV ) , _const ( V0 , _stateid ( massachusetts ) ) ) ) )
what is the length of the red in pennsylvania ?	_answer ( NV , ( _len ( NV , V1 ) , _const ( V0 , _riverid ( red ) ) , _river ( V0 ) , _loc ( V0 , NV ) , _const ( V0 , _stateid ( pennsylvania ) ) ) )
how long is the colorado in miles ?	_answer ( NV , ( _len ( NV , V1 ) , _const ( V0 , _riverid ( colorado ) ) , _river ( V0 ) ) )
where is illinois ?	_answer ( NV , ( _loc ( NV , V1 ) , _const ( V0 , _stateid ( illinois ) ) ) )
what are the names of the major cities in new hampshire ?	_answer ( NV , ( _major ( V0 ) , _city ( V0 ) , _loc ( V0 , NV ) , _const ( V0 , _stateid ( ' new hampshire ' ) ) ) )
what is the smallest state that borders nevada ?	_answer ( NV , _smallest ( V0 , ( _state ( V0 ) , _next_to ( V0 , NV ) , _const ( V0 , _stateid ( nevada ) ) ) ) )
how many states have a city named des moines ?	_answer ( NV , _count ( NV , ( _state ( V0 ) , _loc ( NV , V1 ) , _const ( V0 , _cityid ( ' des moines ' , _ ) ) ) , V2 ) )
what states capital is san jose ?	_answer ( NV , ( _state ( V0 ) , _capital ( V0 , NV ) , _const ( V0 , _cityid ( ' san jose ' , _ ) ) ) )
how many rivers do not traverse the state with the capital san francisco ?	_answer ( NV , _count ( NV , ( _river ( V0 ) , \+ ( _traverse ( V0 , NV ) , _state ( V0 ) , _loc ( NV , V1 ) , _capital ( V0 ) , _const ( V0 , _cityid ( ' san francisco ' , _ ) ) ) ) , V3 ) )
what states border states that border new york ?	_answer ( NV , ( _state ( V0 ) , _next_to ( V0 , NV ) , _state ( V0 ) , _next_to ( V0 , NV ) , _const ( V0 , _stateid ( ' new york ' ) ) ) )
what are the populations of the states through which the colorado run ?	_answer ( NV , ( _population ( NV , V1 ) , _state ( V0 ) , _const ( NV , _riverid ( colorado ) ) , _traverse ( V0 , V1 ) ) )
how long is the potomac ?	_answer ( NV , ( _len ( NV , V1 ) , _const ( V0 , _riverid ( potomac ) ) ) )
where is mount mckinley located ?	_answer ( NV , ( _loc ( NV , V1 ) , _const ( V0 , _placeid ( ' mount mckinley ' ) ) ) )
what are the capitals of the states that border new hampshire ?	_answer ( NV , ( _capital ( V0 ) , _loc ( V0 , NV ) , _state ( V0 ) , _next_to ( V0 , NV ) , _const ( V0 , _stateid ( ' new hampshire ' ) ) ) )
how many people live in san jose ?	_answer ( NV , ( _population ( NV , V1 ) , _const ( V0 , _cityid ( ' san jose ' , _ ) ) ) )
how many people are in the state of ohio ?	_answer ( NV , ( _population ( NV , V1 ) , _const ( V0 , _stateid ( ohio ) ) ) )
how many rivers are found in massachusetts ?	_answer ( NV , _count ( NV , ( _river ( V0 ) , _loc ( V0 , NV ) , _const ( V0 , _stateid ( massachusetts ) ) ) , V2 ) )
where is rochester ?	_answer ( NV , ( _loc ( NV , V1 ) , _const ( V0 , _cityid ( rochester , _ ) ) ) )
what states have a city named des moines ?	_answer ( NV , ( _state ( V0 ) , _loc ( NV , V1 ) , _const ( V0 , _cityid ( ' des moines ' , _ ) ) ) )
what cities in nevada have the highest number of citizens ?	_answer ( NV , _largest ( NV , ( _city ( V1 ) , _loc ( V1 , NV ) , _const ( V0 , _stateid ( nevada ) ) , _population ( V2 , V1 ) ) ) )
through which states does the potomac run ?	_answer ( NV , ( _state ( V0 ) , _const ( NV , _riverid ( potomac ) ) , _traverse ( V0 , V1 ) ) )
which states does the mississippi river pass through ?	_answer ( NV , ( _state ( V0 ) , _const ( NV , _riverid ( mississippi ) ) , _traverse ( V0 , V1 ) ) )
what are the major cities in the states through which the major river in washington runs ?	_answer ( NV , ( _major ( V0 ) , _city ( V0 ) , _loc ( V0 , NV ) , _state ( V0 ) , _river ( NV ) , _loc ( V0 , NV ) , _const ( V0 , _stateid ( washington ) ) , _traverse ( V1 , V2 ) ) )
how many rivers run through alaska ?	_answer ( NV , _count ( NV , ( _river ( V0 ) , _traverse ( V0 , NV ) , _const ( V0 , _stateid ( alaska ) ) ) , V2 ) )
what states border states that the missouri river runs through ?	_answer ( NV , ( _state ( V0 ) , _next_to ( V0 , NV ) , _state ( V0 ) , _const ( NV , _riverid ( missouri ) ) , _traverse ( V0 , V1 ) ) )
which states adjoin vermont ?	_answer ( NV , ( _state ( V0 ) , _next_to ( V0 , NV ) , _const ( V0 , _stateid ( vermont ) ) ) )
what is the length of the colorado river in oklahoma ?	_answer ( NV , ( _len ( NV , V1 ) , _const ( V0 , _riverid ( colorado ) ) , _river ( V0 ) , _loc ( V0 , NV ) , _const ( V0 , _stateid ( oklahoma ) ) ) )
how long is the potomac ?	_answer ( NV , ( _len ( NV , V1 ) , _const ( V0 , _riverid ( potomac ) ) ) )
what rivers run through new mexico ?	_answer ( NV , ( _river ( V0 ) , _traverse ( V0 , NV ) , _const ( V0 , _stateid ( ' new mexico ' ) ) ) )
of the states washed by the potomac which has the lowest point ?	_answer ( NV , _lowest ( NV , ( _state ( V1 ) , _traverse ( NV , V2 ) , _const ( V0 , _riverid ( potomac ) ) , _loc ( V1 , V2 ) , _place ( V1 ) ) ) )
which states does the rio grande river run through ?	_answer ( NV , ( _state ( V0 ) , _const ( NV , _riverid ( ' rio grande ' ) ) , _traverse ( V0 , V1 ) ) )
what rivers run through the states that border the state with the capital flint ?	_answer ( NV , ( _river ( V0 ) , _traverse ( V0 , NV ) , _state ( V0 ) , _next_to ( V0 , NV ) , _state ( V0 ) , _loc ( NV , V1 ) , _capital ( V0 ) , _const ( V0 , _cityid ( flint , _ ) ) ) )
could you tell me what is the highest point in the state of iowa ?	_answer ( NV , _highest ( V0 , ( _place ( V0 ) , _loc ( V0 , NV ) , _state ( V0 ) , _const ( V0 , _stateid ( iowa ) ) ) ) )
how many people are there in alabama ?	_answer ( NV , ( _population ( NV , V1 ) , _const ( V0 , _stateid ( alabama ) ) ) )
how many states have cities or towns named atlanta ?	_answer ( NV , _count ( NV , ( _state ( V0 ) , _loc ( NV , V1 ) , _city ( V0 ) , _const ( V0 , _cityid ( atlanta , _ ) ) ) , V2 ) )
what is the height of the highest mountain in kansas ?	_answer ( NV , ( _elevation ( NV , V1 ) , _highest ( V0 , ( _mountain ( V0 ) , _loc ( V0 , NV ) , _const ( V0 , _stateid ( kansas ) ) ) ) ) )
how many states border on the state whose capital is kalamazoo ?	_answer ( NV , _count ( NV , ( _state ( V0 ) , _next_to ( V0 , NV ) , _state ( V0 ) , _loc ( NV , V1 ) , _capital ( V0 ) , _const ( V0 , _cityid ( kalamazoo , _ ) ) ) , V3 ) )
how many states have cities named columbus ?	_answer ( NV , _count ( NV , ( _state ( V0 ) , _loc ( NV , V1 ) , _city ( V0 ) , _const ( V0 , _cityid ( columbus , _ ) ) ) , V2 ) )
what is the adjacent state of georgia ?	_answer ( NV , ( _next_to ( V0 , NV ) , _state ( V1 ) , _const ( V0 , _stateid ( georgia ) ) ) )
what states are next to the kentucky ?	_answer ( NV , ( _state ( V0 ) , _next_to ( V0 , NV ) , _const ( V0 , _stateid ( kentucky ) ) ) )
how many states have cities named kalamazoo ?	_answer ( NV , _count ( NV , ( _state ( V0 ) , _loc ( NV , V1 ) , _city ( V0 ) , _const ( V0 , _cityid ( kalamazoo , _ ) ) ) , V2 ) )
how many people live in the capital of new hampshire ?	_answer ( NV , ( _population ( NV , V1 ) , _capital ( V0 ) , _loc ( V0 , NV ) , _const ( V0 , _stateid ( ' new hampshire ' ) ) ) )
how many states have cities named flint ?	_answer ( NV , _count ( NV , ( _state ( V0 ) , _loc ( NV , V1 ) , _city ( V0 ) , _const ( V0 , _cityid ( flint , _ ) ) ) , V2 ) )
what maine city has the largest population ?	_answer ( NV , _largest ( NV , ( _const ( NV , _stateid ( maine ) ) , _city ( V2 ) , _loc ( V2 , V0 ) , _population ( V2 , V1 ) ) ) )
which state is the largest city in maryland in ?	_answer ( NV , ( _state ( V0 ) , _largest ( NV , ( _city ( V0 ) , _loc ( V0 , NV ) , _const ( V0 , _stateid ( maryland ) ) ) ) , _loc ( V1 , V2 ) ) )
what is the area of san jose ?	_answer ( NV , ( _area ( NV , V1 ) , _const ( V0 , _cityid ( ' san jose ' , _ ) ) ) )
give me the cities which are in massachusetts ?	_answer ( NV , ( _city ( V0 ) , _loc ( V0 , NV ) , _const ( V0 , _stateid ( massachusetts ) ) ) )
what is the largest city in pennsylvania ?	_answer ( NV , _largest ( V0 , ( _city ( V0 ) , _loc ( V0 , NV ) , _const ( V0 , _stateid ( pennsylvania ) ) ) ) )
how many rivers does maine have ?	_answer ( NV , _count ( NV , ( _river ( V0 ) , _const ( NV , _stateid ( maine ) ) , _loc ( V1 , V0 ) ) , V2 ) )
how many people live in the capital of arkansas ?	_answer ( NV , ( _population ( NV , V1 ) , _capital ( V0 ) , _loc ( V0 , NV ) , _const ( V0 , _stateid ( arkansas ) ) ) )
what states in the united states have a city of san francisco ?	_answer ( NV , ( _state ( V0 ) , _loc ( V0 , NV ) , _const ( V0 , _countryid ( usa ) ) , _loc ( NV , V2 ) , _const ( V0 , _cityid ( ' san francisco ' , _ ) ) ) )
how many states border the colorado river ?	_answer ( NV , _count ( NV , ( _state ( V0 ) , _next_to ( V0 , NV ) , _const ( V0 , _riverid ( colorado ) ) , _river ( V0 ) ) , V2 ) )
what is the highest point in the state with capital new orleans ?	_answer ( NV , _highest ( V0 , ( _place ( V0 ) , _loc ( V0 , NV ) , _state ( V0 ) , _loc ( NV , V1 ) , _capital ( V0 ) , _const ( V0 , _cityid ( ' new orleans ' , _ ) ) ) ) )
how many states have a city called albany ?	_answer ( NV , _count ( NV , ( _state ( V0 ) , _loc ( NV , V1 ) , _const ( V0 , _cityid ( albany , _ ) ) ) , V2 ) )
how big is florida ?	_answer ( NV , ( _size ( NV , V1 ) , _const ( V0 , _stateid ( florida ) ) ) )
what are the highest points of states surrounding new mexico ?	_answer ( NV , _highest ( V0 , ( _place ( V0 ) , _loc ( V0 , NV ) , _state ( V0 ) , _next_to ( V0 , NV ) , _const ( V0 , _stateid ( ' new mexico ' ) ) ) ) )
can you tell me the capital of rhode island ?	_answer ( NV , ( _capital ( V0 ) , _loc ( V0 , NV ) , _const ( V0 , _stateid ( ' rhode island ' ) ) ) )
what rivers flow through rhode island ?	_answer ( NV , ( _river ( V0 ) , _traverse ( V0 , NV ) , _const ( V0 , _stateid ( ' rhode island ' ) ) ) )
what is the most populated state bordering delaware ?	_answer ( NV , _largest ( NV , ( _population ( V1 , V0 ) , _state ( V1 ) , _next_to ( V1 , NV ) , _const ( V0 , _stateid ( delaware ) ) ) ) )
how many states have cities named new york ?	_answer ( NV , _count ( NV , ( _state ( V0 ) , _loc ( NV , V1 ) , _city ( V0 ) , _const ( V0 , _cityid ( ' new york ' , _ ) ) ) , V2 ) )
what states high point are higher than that of minnesota ?	_answer ( NV , ( _state ( V0 ) , _high_point ( V0 , NV ) , _higher ( V0 , NV ) , _high_point ( NV , V1 ) , _const ( V0 , _stateid ( minnesota ) ) ) )
what is the smallest state bordering arizona ?	_answer ( NV , _smallest ( V0 , ( _state ( V0 ) , _next_to ( V0 , NV ) , _const ( V0 , _stateid ( arizona ) ) ) ) )
what is the capital of the state wyoming ?	_answer ( NV , ( _capital ( V0 ) , _loc ( V0 , NV ) , _state ( V0 ) , _const ( V0 , _stateid ( wyoming ) ) ) )
what is the population of the major cities in virginia ?	_answer ( NV , ( _population ( NV , V1 ) , _major ( V0 ) , _city ( V0 ) , _loc ( V0 , NV ) , _const ( V0 , _stateid ( virginia ) ) ) )
what states have a city named boston ?	_answer ( NV , ( _state ( V0 ) , _loc ( NV , V1 ) , _const ( V0 , _cityid ( boston , _ ) ) ) )
what is the longest river that flows through minnesota ?	_answer ( NV , _longest ( V0 , ( _river ( V0 ) , _traverse ( V0 , NV ) , _const ( V0 , _stateid ( minnesota ) ) ) ) )
what are major rivers in colorado ?	_answer ( NV , ( _major ( V0 ) , _river ( V0 ) , _loc ( V0 , NV ) , _const ( V0 , _stateid ( colorado ) ) ) )
what is the density of arkansas ?	_answer ( NV , ( _density ( NV , V1 ) , _const ( V0 , _stateid ( arkansas ) ) ) )
what states have towns named denver ?	_answer ( NV , ( _state ( V0 ) , _loc ( NV , V1 ) , _const ( V0 , _cityid ( denver , _ ) ) ) )
what cities are located in washington ?	_answer ( NV , ( _city ( V0 ) , _loc ( V0 , NV ) , _const ( V0 , _stateid ( washington ) ) ) )
can you tell me the capital of mississippi ?	_answer ( NV , ( _capital ( V0 ) , _loc ( V0 , NV ) , _const ( V0 , _stateid ( mississippi ) ) ) )
what is the largest city in states that border maine ?	_answer ( NV , _largest ( V0 , ( _city ( V0 ) , _loc ( V0 , NV ) , _state ( V0 ) , _next_to ( V0 , NV ) , _const ( V0 , _stateid ( maine ) ) ) ) )
how many people live in the smallest state bordering maryland ?	_answer ( NV , ( _population ( NV , V1 ) , _smallest ( V0 , ( _state ( V0 ) , _next_to ( V0 , NV ) , _const ( V0 , _stateid ( maryland ) ) ) ) ) )
could you tell me what is the highest point in the state of kansas ?	_answer ( NV , _highest ( V0 , ( _place ( V0 ) , _loc ( V0 , NV ) , _state ( V0 ) , _const ( V0 , _stateid ( kansas ) ) ) ) )
where is the highest point in ohio ?	_answer ( NV , _highest ( V0 , ( _place ( V0 ) , _loc ( V0 , NV ) , _const ( V0 , _stateid ( ohio ) ) ) ) )
how many states border vermont and border mississippi ?	_answer ( NV , _count ( NV , ( _state ( V0 ) , _next_to ( V0 , NV ) , _const ( V0 , _stateid ( vermont ) ) , _next_to ( V1 , NV ) , _const ( V0 , _stateid ( mississippi ) ) ) , V3 ) )
what are the names of the major cities in wisconsin ?	_answer ( NV , ( _major ( V0 ) , _city ( V0 ) , _loc ( V0 , NV ) , _const ( V0 , _stateid ( wisconsin ) ) ) )
what state which the red river runs through has the largest population ?	_answer ( NV , _largest ( NV , ( _state ( V1 ) , _const ( NV , _riverid ( red ) ) , _traverse ( V0 , V2 ) , _population ( V2 , V1 ) ) ) )
what states high point are higher than that of michigan ?	_answer ( NV , ( _state ( V0 ) , _high_point ( V0 , NV ) , _higher ( V0 , NV ) , _high_point ( NV , V1 ) , _const ( V0 , _stateid ( michigan ) ) ) )
what are the major cities in hawaii ?	_answer ( NV , ( _major ( V0 ) , _city ( V0 ) , _loc ( V0 , NV ) , _const ( V0 , _stateid ( hawaii ) ) ) )
which rivers run through states bordering alabama ?	_answer ( NV , ( _river ( V0 ) , _traverse ( V0 , NV ) , _state ( V0 ) , _next_to ( V0 , NV ) , _const ( V0 , _stateid ( alabama ) ) ) )
what is the highest mountain in illinois ?	_answer ( NV , _highest ( V0 , ( _mountain ( V0 ) , _loc ( V0 , NV ) , _const ( V0 , _stateid ( illinois ) ) ) ) )
how many people live in utah ?	_answer ( NV , ( _population ( NV , V1 ) , _const ( V0 , _stateid ( utah ) ) ) )
what is the population density of hawaii ?	_answer ( NV , ( _density ( NV , V1 ) , _const ( V0 , _stateid ( hawaii ) ) ) )
number of citizens in new york ?	_answer ( NV , ( _population ( NV , V1 ) , _const ( V0 , _cityid ( ' new york ' , _ ) ) ) )
what is the population in san diego ?	_answer ( NV , ( _population ( NV , V1 ) , _const ( V0 , _cityid ( ' san diego ' , _ ) ) ) )
which states do ohio river flow through ?	_answer ( NV , ( _state ( V0 ) , _const ( NV , _riverid ( ohio ) ) , _river ( V0 ) , _traverse ( V0 , V1 ) ) )
what is the lowest point in the state of maryland ?	_answer ( NV , _lowest ( V0 , ( _place ( V0 ) , _loc ( V0 , NV ) , _state ( V0 ) , _const ( V0 , _stateid ( maryland ) ) ) ) )
what are the populations of the states through which the rio grande run ?	_answer ( NV , ( _population ( NV , V1 ) , _state ( V0 ) , _const ( NV , _riverid ( ' rio grande ' ) ) , _traverse ( V0 , V1 ) ) )
which states does the red pass through ?	_answer ( NV , ( _state ( V0 ) , _const ( NV , _riverid ( red ) ) , _traverse ( V0 , V1 ) ) )
what is the population of the capital of the largest state through which the rio grande runs ?	_answer ( NV , ( _population ( NV , V1 ) , _capital ( V0 ) , _loc ( V0 , NV ) , _largest ( V0 , ( _state ( V0 ) , _const ( NV , _riverid ( ' rio grande ' ) ) , _traverse ( V0 , V1 ) ) ) ) )
which capitals are in the states that border utah ?	_answer ( NV , ( _capital ( V0 ) , _loc ( V0 , NV ) , _state ( V0 ) , _next_to ( V0 , NV ) , _const ( V0 , _stateid ( utah ) ) ) )
what is the capital of the state that borders the state that borders hawaii ?	_answer ( NV , ( _capital ( V0 ) , _loc ( V0 , NV ) , _state ( V0 ) , _next_to ( V0 , NV ) , _state ( V0 ) , _next_to ( V0 , NV ) , _const ( V0 , _stateid ( hawaii ) ) ) )
give me the lakes in mississippi ?	_answer ( NV , ( _lake ( V0 ) , _loc ( V0 , NV ) , _const ( V0 , _stateid ( mississippi ) ) ) )
how many people live in springfield ?	_answer ( NV , ( _population ( NV , V1 ) , _const ( V0 , _cityid ( springfield , _ ) ) ) )
what state has the capital montgomery ?	_answer ( NV , ( _state ( V0 ) , _loc ( NV , V1 ) , _capital ( V0 ) , _const ( V0 , _cityid ( montgomery , _ ) ) ) )
how many states border nevada ?	_answer ( NV , _count ( NV , ( _state ( V0 ) , _next_to ( V0 , NV ) , _const ( V0 , _stateid ( nevada ) ) ) , V2 ) )
what is the lowest elevation in mississippi ?	_answer ( NV , _lowest ( V0 , ( _place ( V0 ) , _loc ( V0 , NV ) , _const ( V0 , _stateid ( mississippi ) ) ) ) )
what are the highest points of states surrounding north carolina ?	_answer ( NV , _highest ( V0 , ( _place ( V0 ) , _loc ( V0 , NV ) , _state ( V0 ) , _next_to ( V0 , NV ) , _const ( V0 , _stateid ( ' north carolina ' ) ) ) ) )
how many rivers are there in illinois ?	_answer ( NV , _count ( NV , ( _river ( V0 ) , _loc ( V0 , NV ) , _const ( V0 , _stateid ( illinois ) ) ) , V2 ) )
states bordering alaska ?	_answer ( NV , ( _state ( V0 ) , _next_to ( V0 , NV ) , _const ( V0 , _stateid ( alaska ) ) ) )
how big is indiana ?	_answer ( NV , ( _size ( NV , V1 ) , _const ( V0 , _stateid ( indiana ) ) ) )
what state has the city pittsburgh ?	_answer ( NV , ( _state ( V0 ) , _loc ( NV , V1 ) , _city ( V0 ) , _const ( V0 , _cityid ( pittsburgh , _ ) ) ) )
what oklahoma city has the largest population ?	_answer ( NV , _largest ( NV , ( _const ( NV , _stateid ( oklahoma ) ) , _city ( V2 ) , _loc ( V2 , V0 ) , _population ( V2 , V1 ) ) ) )
what states neighbor alabama ?	_answer ( NV , ( _state ( V0 ) , _next_to ( V0 , NV ) , _const ( V0 , _stateid ( alabama ) ) ) )
what rivers flow through states that california borders ?	_answer ( NV , ( _river ( V0 ) , _traverse ( V0 , NV ) , _state ( V0 ) , _const ( NV , _stateid ( california ) ) , _next_to ( V0 , V1 ) ) )
which states have a major city named fort wayne ?	_answer ( NV , ( _state ( V0 ) , _loc ( NV , V1 ) , _major ( V0 ) , _city ( V0 ) , _const ( V0 , _cityid ( ' fort wayne ' , _ ) ) ) )
how many rivers in pennsylvania are longer than the colorado ?	_answer ( NV , _count ( NV , ( _river ( V0 ) , _loc ( V0 , NV ) , _const ( V0 , _stateid ( pennsylvania ) ) , _longer ( V1 , NV ) , _const ( V0 , _riverid ( colorado ) ) ) , V3 ) )
what is the largest city in a state that borders kansas ?	_answer ( NV , _largest ( V0 , ( _city ( V0 ) , _loc ( V0 , NV ) , _state ( V0 ) , _next_to ( V0 , NV ) , _const ( V0 , _stateid ( kansas ) ) ) ) )
what states have a city named atlanta ?	_answer ( NV , ( _state ( V0 ) , _loc ( NV , V1 ) , _const ( V0 , _cityid ( atlanta , _ ) ) ) )
what is the population in scotts valley ?	_answer ( NV , ( _population ( NV , V1 ) , _const ( V0 , _cityid ( ' scotts valley ' , _ ) ) ) )
what is the capital of the state idaho ?	_answer ( NV , ( _capital ( V0 ) , _loc ( V0 , NV ) , _state ( V0 ) , _const ( V0 , _stateid ( idaho ) ) ) )
where is the highest point in arizona ?	_answer ( NV , _highest ( V0 , ( _place ( V0 ) , _loc ( V0 , NV ) , _const ( V0 , _stateid ( arizona ) ) ) ) )
what rivers do not run through virginia ?	_answer ( NV , ( _river ( V0 ) , \+ ( _traverse ( V0 , NV ) , _const ( V0 , _stateid ( virginia ) ) ) ) )
name the major lakes in arkansas ?	_answer ( NV , ( _major ( V0 ) , _lake ( V0 ) , _loc ( V0 , NV ) , _const ( V0 , _stateid ( arkansas ) ) ) )
show major cities in tennessee ?	_answer ( NV , ( _major ( V0 ) , _city ( V0 ) , _loc ( V0 , NV ) , _const ( V0 , _stateid ( tennessee ) ) ) )
what is the population density in the state with capital albany ?	_answer ( NV , ( _density ( NV , V1 ) , _state ( V0 ) , _loc ( NV , V1 ) , _capital ( V0 ) , _const ( V0 , _cityid ( albany , _ ) ) ) )
what is the shortest river in delaware ?	_answer ( NV , _shortest ( V0 , ( _river ( V0 ) , _loc ( V0 , NV ) , _const ( V0 , _stateid ( delaware ) ) ) ) )
what is the largest city of iowa ?	_answer ( NV , _largest ( V0 , ( _city ( V0 ) , _loc ( V0 , NV ) , _const ( V0 , _stateid ( iowa ) ) ) ) )
what is the highest mountain in new hampshire ?	_answer ( NV , _highest ( V0 , ( _mountain ( V0 ) , _loc ( V0 , NV ) , _const ( V0 , _stateid ( ' new hampshire ' ) ) ) ) )
what states capital is new york ?	_answer ( NV , ( _state ( V0 ) , _capital ( V0 , NV ) , _const ( V0 , _cityid ( ' new york ' , _ ) ) ) )
what is the population of san francisco ga ?	_answer ( NV , ( _population ( NV , V1 ) , _const ( V0 , _cityid ( ' san francisco ' , _ ) ) ) )
where is washington ?	_answer ( NV , ( _loc ( NV , V1 ) , _const ( V0 , _stateid ( washington ) ) ) )
how many states have cities named san diego ?	_answer ( NV , _count ( NV , ( _state ( V0 ) , _loc ( NV , V1 ) , _city ( V0 ) , _const ( V0 , _cityid ( ' san diego ' , _ ) ) ) , V2 ) )
what is the smallest city in maryland ?	_answer ( NV , _smallest ( V0 , ( _city ( V0 ) , _loc ( V0 , NV ) , _const ( V0 , _stateid ( maryland ) ) ) ) )
which rivers flow through kansas ?	_answer ( NV , ( _river ( V0 ) , _traverse ( V0 , NV ) , _const ( V0 , _stateid ( kansas ) ) ) )
what is the adjacent state of kentucky ?	_answer ( NV , ( _next_to ( V0 , NV ) , _state ( V1 ) , _const ( V0 , _stateid ( kentucky ) ) ) )
what river flows through south dakota ?	_answer ( NV , ( _river ( V0 ) , _traverse ( V0 , NV ) , _const ( V0 , _stateid ( ' south dakota ' ) ) ) )
which state borders new mexico ?	_answer ( NV , ( _state ( V0 ) , _next_to ( V0 , NV ) , _const ( V0 , _stateid ( ' new mexico ' ) ) ) )
what is the population of the capital of the largest state through which the ohio river runs ?	_answer ( NV , ( _population ( NV , V1 ) , _capital ( V0 ) , _loc ( V0 , NV ) , _largest ( V0 , ( _state ( V0 ) , _const ( NV , _riverid ( ohio ) ) , _traverse ( V0 , V1 ) ) ) ) )
what states have a city named boston ?	_answer ( NV , ( _state ( V0 ) , _loc ( NV , V1 ) , _const ( V0 , _cityid ( boston , _ ) ) ) )
where is guadalupe peak located ?	_answer ( NV , ( _loc ( NV , V1 ) , _const ( V0 , _placeid ( ' guadalupe peak ' ) ) ) )
what are the major cities in the states through which the major river in georgia runs ?	_answer ( NV , ( _major ( V0 ) , _city ( V0 ) , _loc ( V0 , NV ) , _state ( V0 ) , _river ( NV ) , _loc ( V0 , NV ) , _const ( V0 , _stateid ( georgia ) ) , _traverse ( V1 , V2 ) ) )
what state has the city columbus ?	_answer ( NV , ( _state ( V0 ) , _loc ( NV , V1 ) , _city ( V0 ) , _const ( V0 , _cityid ( columbus , _ ) ) ) )
what is the capital of the state that borders the state that borders new york ?	_answer ( NV , ( _capital ( V0 ) , _loc ( V0 , NV ) , _state ( V0 ) , _next_to ( V0 , NV ) , _state ( V0 ) , _next_to ( V0 , NV ) , _const ( V0 , _stateid ( ' new york ' ) ) ) )
what are the populations of states through which the red run ?	_answer ( NV , ( _population ( NV , V1 ) , _state ( V0 ) , _const ( NV , _riverid ( red ) ) , _traverse ( V0 , V1 ) ) )
which state is the city flint located in ?	_answer ( NV , ( _state ( V0 ) , _city ( NV ) , _const ( V0 , _cityid ( flint , _ ) ) , _loc ( V0 , V1 ) ) )
which states border maine ?	_answer ( NV , ( _state ( V0 ) , _next_to ( V0 , NV ) , _const ( V0 , _stateid ( maine ) ) ) )
where is death valley ?	_answer ( NV , ( _loc ( NV , V1 ) , _const ( V0 , _placeid ( ' death valley ' ) ) ) )
what is the capital of virginia ?	_answer ( NV , ( _capital ( V0 ) , _loc ( V0 , NV ) , _const ( V0 , _stateid ( virginia ) ) ) )
what is the area of columbus ?	_answer ( NV , ( _area ( NV , V1 ) , _const ( V0 , _cityid ( columbus , _ ) ) ) )
what are the capitals of the states that border tennessee ?	_answer ( NV , ( _capital ( V0 ) , _loc ( V0 , NV ) , _state ( V0 ) , _next_to ( V0 , NV ) , _const ( V0 , _stateid ( tennessee ) ) ) )
name all the rivers in arkansas ?	_answer ( NV , ( _river ( V0 ) , _loc ( V0 , NV ) , _const ( V0 , _stateid ( arkansas ) ) ) )
how many rivers in south dakota are longer than the potomac ?	_answer ( NV , _count ( NV , ( _river ( V0 ) , _loc ( V0 , NV ) , _const ( V0 , _stateid ( ' south dakota ' ) ) , _longer ( V1 , NV ) , _const ( V0 , _riverid ( potomac ) ) ) , V3 ) )
how many rivers does hawaii have ?	_answer ( NV , _count ( NV , ( _river ( V0 ) , _const ( NV , _stateid ( hawaii ) ) , _loc ( V1 , V0 ) ) , V2 ) )
what state has the city boston ?	_answer ( NV , ( _state ( V0 ) , _loc ( NV , V1 ) , _city ( V0 ) , _const ( V0 , _cityid ( boston , _ ) ) ) )
what is the longest river that runs through a state that borders texas ?	_answer ( NV , _longest ( V0 , ( _river ( V0 ) , _traverse ( V0 , NV ) , _state ( V0 ) , _next_to ( V0 , NV ) , _const ( V0 , _stateid ( texas ) ) ) ) )
what is the total population of the states that border massachusetts ?	_answer ( NV , _sum ( NV , ( _state ( V0 ) , _next_to ( NV , V1 ) , _const ( V0 , _stateid ( massachusetts ) ) ) , _population ( V1 ) , V2 ) )
which state is new orleans in ?	_answer ( NV , ( _state ( V0 ) , _const ( NV , _cityid ( ' new orleans ' , _ ) ) , _loc ( V0 , V1 ) ) )
austin is the capital of which state ?	_answer ( NV , ( _const ( NV , _cityid ( austin , _ ) ) , _capital ( V0 ) , _loc ( V0 , V1 ) , _state ( V1 ) ) )
what is the capital of arkansas ?	_answer ( NV , ( _capital ( V0 ) , _loc ( V0 , NV ) , _const ( V0 , _stateid ( arkansas ) ) ) )
what is the population of the largest state that borders pennsylvania ?	_answer ( NV , ( _population ( NV , V1 ) , _largest ( V0 , ( _state ( V0 ) , _next_to ( V0 , NV ) , _const ( V0 , _stateid ( pennsylvania ) ) ) ) ) )
what is the lowest point of arizona ?	_answer ( NV , _lowest ( V0 , ( _place ( V0 ) , _loc ( V0 , NV ) , _const ( V0 , _stateid ( arizona ) ) ) ) )
what is the height of the highest mountain in idaho ?	_answer ( NV , ( _elevation ( NV , V1 ) , _highest ( V0 , ( _mountain ( V0 ) , _loc ( V0 , NV ) , _const ( V0 , _stateid ( idaho ) ) ) ) ) )
what states border states that the rio grande river runs through ?	_answer ( NV , ( _state ( V0 ) , _next_to ( V0 , NV ) , _state ( V0 ) , _const ( NV , _riverid ( ' rio grande ' ) ) , _traverse ( V0 , V1 ) ) )
what state is new orleans the capital of ?	_answer ( NV , ( _state ( V0 ) , _const ( NV , _cityid ( ' new orleans ' , _ ) ) , _capital ( V0 ) , _loc ( V0 , V1 ) ) )
how many people live in pittsburgh ?	_answer ( NV , ( _population ( NV , V1 ) , _const ( V0 , _cityid ( pittsburgh , _ ) ) ) )
how many cities named dallas are there in the usa ?	_answer ( NV , _count ( NV , ( _city ( V0 ) , _const ( V0 , _cityid ( dallas , _ ) ) , _loc ( V0 , NV ) , _const ( V0 , _countryid ( usa ) ) ) , V2 ) )
which states border ohio ?	_answer ( NV , ( _state ( V0 ) , _next_to ( V0 , NV ) , _const ( V0 , _stateid ( ohio ) ) ) )
which states do mississippi flow through ?	_answer ( NV , ( _state ( V0 ) , _const ( NV , _riverid ( mississippi ) ) , _river ( V0 ) , _traverse ( V0 , V1 ) ) )
what state that borders illinois has the highest population ?	_answer ( NV , _largest ( NV , ( _state ( V1 ) , _next_to ( V1 , NV ) , _const ( V0 , _stateid ( illinois ) ) , _population ( V2 , V1 ) ) ) )
which state has the rio grande ?	_answer ( NV , ( _state ( V0 ) , _loc ( NV , V1 ) , _const ( V0 , _riverid ( ' rio grande ' ) ) , _river ( V0 ) ) )
what is the total population of the states that border missouri ?	_answer ( NV , _sum ( NV , ( _state ( V0 ) , _next_to ( NV , V1 ) , _const ( V0 , _stateid ( missouri ) ) ) , _population ( V1 ) , V2 ) )
name the rivers in arizona ?	_answer ( NV , ( _river ( V0 ) , _loc ( V0 , NV ) , _const ( V0 , _stateid ( arizona ) ) ) )
which states have a major city named dover ?	_answer ( NV , ( _state ( V0 ) , _loc ( NV , V1 ) , _major ( V0 ) , _city ( V0 ) , _const ( V0 , _cityid ( dover , _ ) ) ) )
what mountains are in rhode island ?	_answer ( NV , ( _mountain ( V0 ) , _loc ( V0 , NV ) , _const ( V0 , _stateid ( ' rhode island ' ) ) ) )
how many people are there in california ?	_answer ( NV , ( _population ( NV , V1 ) , _const ( V0 , _stateid ( california ) ) ) )
what are the highest points of states surrounding iowa ?	_answer ( NV , _highest ( V0 , ( _place ( V0 ) , _loc ( V0 , NV ) , _state ( V0 ) , _next_to ( V0 , NV ) , _const ( V0 , _stateid ( iowa ) ) ) ) )
what states does the potomac go through ?	_answer ( NV , ( _state ( V0 ) , _const ( NV , _riverid ( potomac ) ) , _river ( V0 ) , _traverse ( V0 , V1 ) ) )
through which states does the potomac run ?	_answer ( NV , ( _state ( V0 ) , _const ( NV , _riverid ( potomac ) ) , _traverse ( V0 , V1 ) ) )
which states does not border north dakota ?	_answer ( NV , ( _state ( V0 ) , \+ ( _next_to ( V0 , NV ) , _const ( V0 , _stateid ( ' north dakota ' ) ) ) ) )
what is the city in montana with the largest population ?	_answer ( NV , _largest ( NV , ( _city ( V1 ) , _loc ( V1 , NV ) , _const ( V0 , _stateid ( montana ) ) , _population ( V2 , V1 ) ) ) )
what state has the city pittsburgh ?	_answer ( NV , ( _state ( V0 ) , _loc ( NV , V1 ) , _city ( V0 ) , _const ( V0 , _cityid ( pittsburgh , _ ) ) ) )
what states does the rio grande river go through ?	_answer ( NV , ( _state ( V0 ) , _const ( NV , _riverid ( ' rio grande ' ) ) , _river ( V0 ) , _traverse ( V0 , V1 ) ) )
what is the largest of the state that the red runs through ?	_answer ( NV , _largest ( V0 , ( _state ( V0 ) , _const ( NV , _riverid ( red ) ) , _traverse ( V0 , V1 ) ) ) )
what is the lowest point in the state of tennessee ?	_answer ( NV , _lowest ( V0 , ( _place ( V0 ) , _loc ( V0 , NV ) , _state ( V0 ) , _const ( V0 , _stateid ( tennessee ) ) ) ) )
what is the largest state traversed by the missouri river ?	_answer ( NV , _largest ( V0 , ( _state ( V0 ) , _traverse ( NV , V1 ) , _const ( V0 , _riverid ( missouri ) ) ) ) )
how many rivers are called mississippi ?	_answer ( NV , _count ( NV , ( _river ( V0 ) , _const ( V0 , _riverid ( mississippi ) ) ) , V1 ) )
what are the cities in north dakota ?	_answer ( NV , ( _city ( V0 ) , _loc ( V0 , NV ) , _const ( V0 , _stateid ( ' north dakota ' ) ) ) )
what rivers are in delaware ?	_answer ( NV , ( _river ( V0 ) , _loc ( V0 , NV ) , _const ( V0 , _stateid ( delaware ) ) ) )
what are the cities in new york ?	_answer ( NV , ( _city ( V0 ) , _loc ( V0 , NV ) , _const ( V0 , _stateid ( ' new york ' ) ) ) )
how many cities does illinois have ?	_answer ( NV , _count ( NV , ( _city ( V0 ) , _const ( NV , _stateid ( illinois ) ) , _loc ( V1 , V0 ) ) , V2 ) )
what are the rivers of south dakota ?	_answer ( NV , ( _river ( V0 ) , _loc ( V0 , NV ) , _const ( V0 , _stateid ( ' south dakota ' ) ) ) )
what are the states that the rio grande run through ?	_answer ( NV , ( _state ( V0 ) , _const ( NV , _riverid ( ' rio grande ' ) ) , _traverse ( V0 , V1 ) ) )
give me the cities which are in delaware ?	_answer ( NV , ( _city ( V0 ) , _loc ( V0 , NV ) , _const ( V0 , _stateid ( delaware ) ) ) )
what is the elevation of mount whitney ?	_answer ( NV , ( _elevation ( NV , V1 ) , _const ( V0 , _placeid ( ' mount whitney ' ) ) ) )
name all the rivers in oklahoma ?	_answer ( NV , ( _river ( V0 ) , _loc ( V0 , NV ) , _const ( V0 , _stateid ( oklahoma ) ) ) )
how many rivers does oregon have ?	_answer ( NV , _count ( NV , ( _river ( V0 ) , _const ( NV , _stateid ( oregon ) ) , _loc ( V1 , V0 ) ) , V2 ) )
through which states does the rio grande river run ?	_answer ( NV , ( _state ( V0 ) , _const ( NV , _riverid ( ' rio grande ' ) ) , _traverse ( V0 , V1 ) ) )
what are the cities in washington ?	_answer ( NV , ( _city ( V0 ) , _loc ( V0 , NV ) , _const ( V0 , _stateid ( washington ) ) ) )
what states have cities named san diego ?	_answer ( NV , ( _state ( V0 ) , _loc ( NV , V1 ) , _city ( V0 ) , _const ( V0 , _cityid ( ' san diego ' , _ ) ) ) )
what is the largest city in maine ?	_answer ( NV , _largest ( V0 , ( _city ( V0 ) , _loc ( V0 , NV ) , _const ( V0 , _stateid ( maine ) ) ) ) )
how many major cities are there in kentucky ?	_answer ( NV , _count ( NV , ( _major ( V0 ) , _city ( V0 ) , _loc ( V0 , NV ) , _const ( V0 , _stateid ( kentucky ) ) ) , V2 ) )
what is the largest city in states that border oregon ?	_answer ( NV , _largest ( V0 , ( _city ( V0 ) , _loc ( V0 , NV ) , _state ( V0 ) , _next_to ( V0 , NV ) , _const ( V0 , _stateid ( oregon ) ) ) ) )
which capitals are in the states that border oklahoma ?	_answer ( NV , ( _capital ( V0 ) , _loc ( V0 , NV ) , _state ( V0 ) , _next_to ( V0 , NV ) , _const ( V0 , _stateid ( oklahoma ) ) ) )
what states border states that border states that border texas ?	_answer ( NV , ( _state ( V0 ) , _next_to ( V0 , NV ) , _state ( V0 ) , _next_to ( V0 , NV ) , _state ( V0 ) , _next_to ( V0 , NV ) , _const ( V0 , _stateid ( texas ) ) ) )
which states have points higher than the highest point in kansas ?	_answer ( NV , ( _state ( V0 ) , _loc ( NV , V1 ) , _place ( V0 ) , _higher ( V0 , NV ) , _highest ( V0 , ( _place ( V0 ) , _loc ( V0 , NV ) , _const ( V0 , _stateid ( kansas ) ) ) ) ) )
what river runs through north carolina ?	_answer ( NV , ( _river ( V0 ) , _traverse ( V0 , NV ) , _const ( V0 , _stateid ( ' north carolina ' ) ) ) )
what state borders the least states excluding massachusetts and excluding pennsylvania ?	_answer ( NV , _fewest ( V0 , NV , ( _state ( V1 ) , _next_to ( V1 , V0 ) , _state ( V0 ) , \+ _const ( V1 , _stateid ( massachusetts ) ) , \+ _const ( V1 , _stateid ( pennsylvania ) ) ) ) )
which state is scotts valley in ?	_answer ( NV , ( _state ( V0 ) , _const ( NV , _cityid ( ' scotts valley ' , _ ) ) , _loc ( V0 , V1 ) ) )
how many major cities are there in massachusetts ?	_answer ( NV , _count ( NV , ( _major ( V0 ) , _city ( V0 ) , _loc ( V0 , NV ) , _const ( V0 , _stateid ( massachusetts ) ) ) , V2 ) )
what is the smallest city in arizona ?	_answer ( NV , _smallest ( V0 , ( _city ( V0 ) , _loc ( V0 , NV ) , _const ( V0 , _stateid ( arizona ) ) ) ) )
how many people live in indiana ?	_answer ( NV , ( _population ( NV , V1 ) , _const ( V0 , _stateid ( indiana ) ) ) )
what cities in michigan have the highest populations ?	_answer ( NV , _largest ( NV , ( _city ( V1 ) , _loc ( V1 , NV ) , _const ( V0 , _stateid ( michigan ) ) , _population ( V2 , V1 ) ) ) )
give me the lakes in maryland ?	_answer ( NV , ( _lake ( V0 ) , _loc ( V0 , NV ) , _const ( V0 , _stateid ( maryland ) ) ) )
what is the population of san francisco ga ?	_answer ( NV , ( _population ( NV , V1 ) , _const ( V0 , _cityid ( ' san francisco ' , _ ) ) ) )
how high is the highest point in idaho ?	_answer ( NV , ( _elevation ( NV , V1 ) , _highest ( V0 , ( _place ( V0 ) , _loc ( V0 , NV ) , _const ( V0 , _stateid ( idaho ) ) ) ) ) )
which states border delaware ?	_answer ( NV , ( _state ( V0 ) , _next_to ( V0 , NV ) , _const ( V0 , _stateid ( delaware ) ) ) )
what state is new orleans in ?	_answer ( NV , ( _state ( V0 ) , _const ( NV , _cityid ( ' new orleans ' , _ ) ) , _loc ( V0 , V1 ) ) )
how many major rivers cross mississippi ?	_answer ( NV , _count ( NV , ( _major ( V0 ) , _river ( V0 ) , _traverse ( V0 , NV ) , _const ( V0 , _stateid ( mississippi ) ) ) , V2 ) )
how many states does the colorado run through ?	_answer ( NV , _count ( NV , ( _state ( V0 ) , _const ( NV , _riverid ( colorado ) ) , _traverse ( V0 , V1 ) ) , V2 ) )
what river runs through maryland ?	_answer ( NV , ( _river ( V0 ) , _traverse ( V0 , NV ) , _const ( V0 , _stateid ( maryland ) ) ) )
what is the biggest river in ohio ?	_answer ( NV , _largest ( V0 , ( _river ( V0 ) , _loc ( V0 , NV ) , _const ( V0 , _stateid ( ohio ) ) ) ) )
what is the total population of the states that border new mexico ?	_answer ( NV , _sum ( NV , ( _state ( V0 ) , _next_to ( NV , V1 ) , _const ( V0 , _stateid ( ' new mexico ' ) ) ) , _population ( V1 ) , V2 ) )
how many rivers are found in wyoming ?	_answer ( NV , _count ( NV , ( _river ( V0 ) , _loc ( V0 , NV ) , _const ( V0 , _stateid ( wyoming ) ) ) , V2 ) )
which state borders iowa ?	_answer ( NV , ( _state ( V0 ) , _next_to ( V0 , NV ) , _const ( V0 , _stateid ( iowa ) ) ) )
where is death valley located ?	_answer ( NV , ( _loc ( NV , V1 ) , _const ( V0 , _placeid ( ' death valley ' ) ) ) )
which states have a major city named flint ?	_answer ( NV , ( _state ( V0 ) , _loc ( NV , V1 ) , _major ( V0 ) , _city ( V0 ) , _const ( V0 , _cityid ( flint , _ ) ) ) )
where is guadalupe peak ?	_answer ( NV , ( _loc ( NV , V1 ) , _const ( V0 , _placeid ( ' guadalupe peak ' ) ) ) )
how many people live in the smallest state bordering mississippi ?	_answer ( NV , ( _population ( NV , V1 ) , _smallest ( V0 , ( _state ( V0 ) , _next_to ( V0 , NV ) , _const ( V0 , _stateid ( mississippi ) ) ) ) ) )
show major cities in south dakota ?	_answer ( NV , ( _major ( V0 ) , _city ( V0 ) , _loc ( V0 , NV ) , _const ( V0 , _stateid ( ' south dakota ' ) ) ) )
what state that borders mississippi is the largest ?	_answer ( NV , _largest ( V0 , ( _state ( V0 ) , _next_to ( V0 , NV ) , _const ( V0 , _stateid ( mississippi ) ) ) ) )
which state is the largest city in rhode island in ?	_answer ( NV , ( _state ( V0 ) , _largest ( NV , ( _city ( V0 ) , _loc ( V0 , NV ) , _const ( V0 , _stateid ( ' rhode island ' ) ) ) ) , _loc ( V1 , V2 ) ) )
which state has the smallest area that borders delaware ?	_answer ( NV , _smallest ( NV , ( _state ( V1 ) , _area ( V1 , V0 ) , _next_to ( V1 , NV ) , _const ( V0 , _stateid ( delaware ) ) ) ) )
what state that borders oklahoma is the largest ?	_answer ( NV , _largest ( V0 , ( _state ( V0 ) , _next_to ( V0 , NV ) , _const ( V0 , _stateid ( oklahoma ) ) ) ) )
how many citizens in boston ?	_answer ( NV , ( _population ( NV , V1 ) , _const ( V0 , _cityid ( boston , _ ) ) ) )
what is the largest state that borders new york ?	_answer ( NV , _largest ( V0 , ( _state ( V0 ) , _next_to ( V0 , NV ) , _const ( V0 , _stateid ( ' new york ' ) ) ) ) )
what rivers flow through states that north dakota borders ?	_answer ( NV , ( _river ( V0 ) , _traverse ( V0 , NV ) , _state ( V0 ) , _const ( NV , _stateid ( ' north dakota ' ) ) , _next_to ( V0 , V1 ) ) )
what are major rivers in maine ?	_answer ( NV , ( _major ( V0 ) , _river ( V0 ) , _loc ( V0 , NV ) , _const ( V0 , _stateid ( maine ) ) ) )
what are the major cities in the states through which the major river in new hampshire runs ?	_answer ( NV , ( _major ( V0 ) , _city ( V0 ) , _loc ( V0 , NV ) , _state ( V0 ) , _river ( NV ) , _loc ( V0 , NV ) , _const ( V0 , _stateid ( ' new hampshire ' ) ) , _traverse ( V1 , V2 ) ) )
what is the longest river that flows through ohio ?	_answer ( NV , _longest ( V0 , ( _river ( V0 ) , _traverse ( V0 , NV ) , _const ( V0 , _stateid ( ohio ) ) ) ) )
what is the longest river that runs through a state that borders new hampshire ?	_answer ( NV , _longest ( V0 , ( _river ( V0 ) , _traverse ( V0 , NV ) , _state ( V0 ) , _next_to ( V0 , NV ) , _const ( V0 , _stateid ( ' new hampshire ' ) ) ) ) )
how many inhabitants does houston have ?	_answer ( NV , ( _population ( NV , V1 ) , _const ( V0 , _cityid ( houston , _ ) ) ) )
what is the capital of the state that borders the state that borders montana ?	_answer ( NV , ( _capital ( V0 ) , _loc ( V0 , NV ) , _state ( V0 ) , _next_to ( V0 , NV ) , _state ( V0 ) , _next_to ( V0 , NV ) , _const ( V0 , _stateid ( montana ) ) ) )
how many states have cities named boston ?	_answer ( NV , _count ( NV , ( _state ( V0 ) , _loc ( NV , V1 ) , _city ( V0 ) , _const ( V0 , _cityid ( boston , _ ) ) ) , V2 ) )
what states are next to the idaho ?	_answer ( NV , ( _state ( V0 ) , _next_to ( V0 , NV ) , _const ( V0 , _stateid ( idaho ) ) ) )
how many major cities are in louisiana ?	_answer ( NV , _count ( NV , ( _major ( V0 ) , _city ( V0 ) , _loc ( V0 , NV ) , _const ( V0 , _stateid ( louisiana ) ) ) , V2 ) )
which state borders alabama ?	_answer ( NV , ( _state ( V0 ) , _next_to ( V0 , NV ) , _const ( V0 , _stateid ( alabama ) ) ) )
how many rivers run through the states bordering new hampshire ?	_answer ( NV , _count ( NV , ( _river ( V0 ) , _traverse ( V0 , NV ) , _state ( V0 ) , _next_to ( V0 , NV ) , _const ( V0 , _stateid ( ' new hampshire ' ) ) ) , V3 ) )
how many rivers are found in hawaii ?	_answer ( NV , _count ( NV , ( _river ( V0 ) , _loc ( V0 , NV ) , _const ( V0 , _stateid ( hawaii ) ) ) , V2 ) )
what are the populations of the states through which the potomac run ?	_answer ( NV , ( _population ( NV , V1 ) , _state ( V0 ) , _const ( NV , _riverid ( potomac ) ) , _river ( V0 ) , _traverse ( V0 , V1 ) ) )
which states have points that are higher than the highest point in new mexico ?	_answer ( NV , ( _state ( V0 ) , _place ( NV ) , _loc ( V0 , V1 ) , _higher ( V0 , NV ) , _highest ( V0 , ( _place ( V0 ) , _loc ( V0 , NV ) , _const ( V0 , _stateid ( ' new mexico ' ) ) ) ) ) )
how high is the highest point of rhode island ?	_answer ( NV , ( _elevation ( NV , V1 ) , _highest ( V0 , ( _place ( V0 ) , _loc ( V0 , NV ) , _const ( V0 , _stateid ( ' rhode island ' ) ) ) ) ) )
how big is the city of indianapolis ?	_answer ( NV , ( _size ( NV , V1 ) , _const ( V0 , _cityid ( indianapolis , _ ) ) ) )
what state that borders florida has the highest population ?	_answer ( NV , _largest ( NV , ( _state ( V1 ) , _next_to ( V1 , NV ) , _const ( V0 , _stateid ( florida ) ) , _population ( V2 , V1 ) ) ) )
how many states have cities named albany ?	_answer ( NV , _count ( NV , ( _state ( V0 ) , _loc ( NV , V1 ) , _city ( V0 ) , _const ( V0 , _cityid ( albany , _ ) ) ) , V2 ) )
what state borders ohio ?	_answer ( NV , ( _state ( V0 ) , _next_to ( V0 , NV ) , _const ( V0 , _stateid ( ohio ) ) ) )
how many states border nebraska and border missouri ?	_answer ( NV , _count ( NV , ( _state ( V0 ) , _next_to ( V0 , NV ) , _const ( V0 , _stateid ( nebraska ) ) , _next_to ( V1 , NV ) , _const ( V0 , _stateid ( missouri ) ) ) , V3 ) )
what states have a city named houston ?	_answer ( NV , ( _state ( V0 ) , _loc ( NV , V1 ) , _const ( V0 , _cityid ( houston , _ ) ) ) )
can you tell me the capital of alaska ?	_answer ( NV , ( _capital ( V0 ) , _loc ( V0 , NV ) , _const ( V0 , _stateid ( alaska ) ) ) )
what is the population density in the state with capital indianapolis ?	_answer ( NV , ( _density ( NV , V1 ) , _state ( V0 ) , _loc ( NV , V1 ) , _capital ( V0 ) , _const ( V0 , _cityid ( indianapolis , _ ) ) ) )
what is the area of wyoming in square kilometers ?	_answer ( NV , ( _area ( NV , V1 ) , _const ( V0 , _stateid ( wyoming ) ) ) )
what is the population of the major cities in arkansas ?	_answer ( NV , ( _population ( NV , V1 ) , _major ( V0 ) , _city ( V0 ) , _loc ( V0 , NV ) , _const ( V0 , _stateid ( arkansas ) ) ) )
name all the rivers in washington ?	_answer ( NV , ( _river ( V0 ) , _loc ( V0 , NV ) , _const ( V0 , _stateid ( washington ) ) ) )
how high is mount mckinley ?	_answer ( NV , ( _elevation ( NV , V1 ) , _const ( V0 , _placeid ( ' mount mckinley ' ) ) ) )
which rivers run through states bordering north carolina ?	_answer ( NV , ( _river ( V0 ) , _traverse ( V0 , NV ) , _state ( V0 ) , _next_to ( V0 , NV ) , _const ( V0 , _stateid ( ' north carolina ' ) ) ) )
how many major cities are there in california ?	_answer ( NV , _count ( NV , ( _major ( V0 ) , _city ( V0 ) , _loc ( V0 , NV ) , _const ( V0 , _stateid ( california ) ) ) , V2 ) )
which state has the smallest area that borders rhode island ?	_answer ( NV , _smallest ( NV , ( _state ( V1 ) , _area ( V1 , V0 ) , _next_to ( V1 , NV ) , _const ( V0 , _stateid ( ' rhode island ' ) ) ) ) )
what are the capitals of the states that border massachusetts ?	_answer ( NV , ( _capital ( V0 ) , _loc ( V0 , NV ) , _state ( V0 ) , _next_to ( V0 , NV ) , _const ( V0 , _stateid ( massachusetts ) ) ) )
what are the high points of states surrounding massachusetts ?	_answer ( NV , ( _high_point ( NV , V1 ) , _loc ( V1 , V0 ) , _state ( V0 ) , _next_to ( V0 , NV ) , _const ( V0 , _stateid ( massachusetts ) ) ) )
which states adjoin vermont ?	_answer ( NV , ( _state ( V0 ) , _next_to ( V0 , NV ) , _const ( V0 , _stateid ( vermont ) ) ) )
how many cities named seattle are there in the usa ?	_answer ( NV , _count ( NV , ( _city ( V0 ) , _const ( V0 , _cityid ( seattle , _ ) ) , _loc ( V0 , NV ) , _const ( V0 , _countryid ( usa ) ) ) , V2 ) )
what are the populations of the states through which the potomac run ?	_answer ( NV , ( _population ( NV , V1 ) , _state ( V0 ) , _const ( NV , _riverid ( potomac ) ) , _traverse ( V0 , V1 ) ) )
what are the populations of the states through which the potomac run ?	_answer ( NV , ( _population ( NV , V1 ) , _state ( V0 ) , _const ( NV , _riverid ( potomac ) ) , _river ( V0 ) , _traverse ( V0 , V1 ) ) )
what states neighbor new york ?	_answer ( NV , ( _state ( V0 ) , _next_to ( V0 , NV ) , _const ( V0 , _stateid ( ' new york ' ) ) ) )
what states border states which the missouri river runs through ?	_answer ( NV , ( _state ( V0 ) , _next_to ( V0 , NV ) , _state ( V0 ) , _const ( NV , _riverid ( missouri ) ) , _traverse ( V0 , V1 ) ) )
what is the population density in the state with capital dallas ?	_answer ( NV , ( _density ( NV , V1 ) , _state ( V0 ) , _loc ( NV , V1 ) , _capital ( V0 ) , _const ( V0 , _cityid ( dallas , _ ) ) ) )
how many cities named rochester are there in the usa ?	_answer ( NV , _count ( NV , ( _city ( V0 ) , _const ( V0 , _cityid ( rochester , _ ) ) , _loc ( V0 , NV ) , _const ( V0 , _countryid ( usa ) ) ) , V2 ) )
what state borders delaware ?	_answer ( NV , ( _state ( V0 ) , _next_to ( V0 , NV ) , _const ( V0 , _stateid ( delaware ) ) ) )
what are the populations of states through which the colorado run ?	_answer ( NV , ( _population ( NV , V1 ) , _state ( V0 ) , _const ( NV , _riverid ( colorado ) ) , _river ( V0 ) , _traverse ( V0 , V1 ) ) )
which states adjoin delaware ?	_answer ( NV , ( _state ( V0 ) , _next_to ( V0 , NV ) , _const ( V0 , _stateid ( delaware ) ) ) )
how many rivers run through the states bordering louisiana ?	_answer ( NV , _count ( NV , ( _river ( V0 ) , _traverse ( V0 , NV ) , _state ( V0 ) , _next_to ( V0 , NV ) , _const ( V0 , _stateid ( louisiana ) ) ) , V3 ) )
what is the lowest point in the state of florida ?	_answer ( NV , _lowest ( V0 , ( _place ( V0 ) , _loc ( V0 , NV ) , _state ( V0 ) , _const ( V0 , _stateid ( florida ) ) ) ) )
which state has the smallest area that borders michigan ?	_answer ( NV , _smallest ( NV , ( _state ( V1 ) , _area ( V1 , V0 ) , _next_to ( V1 , NV ) , _const ( V0 , _stateid ( michigan ) ) ) ) )
what are the populations of the states through which the colorado river run ?	_answer ( NV , ( _population ( NV , V1 ) , _state ( V0 ) , _const ( NV , _riverid ( colorado ) ) , _river ( V0 ) , _traverse ( V0 , V1 ) ) )
what state that borders nebraska has the highest population ?	_answer ( NV , _largest ( NV , ( _state ( V1 ) , _next_to ( V1 , NV ) , _const ( V0 , _stateid ( nebraska ) ) , _population ( V2 , V1 ) ) ) )
what is the height of the highest mountain in indiana ?	_answer ( NV , ( _elevation ( NV , V1 ) , _highest ( V0 , ( _mountain ( V0 ) , _loc ( V0 , NV ) , _const ( V0 , _stateid ( indiana ) ) ) ) ) )
how many citizens in houston ?	_answer ( NV , ( _population ( NV , V1 ) , _const ( V0 , _cityid ( houston , _ ) ) ) )
which states does the rio grande river run through ?	_answer ( NV , ( _state ( V0 ) , _const ( NV , _riverid ( ' rio grande ' ) ) , _traverse ( V0 , V1 ) ) )
of the states washed by the rio grande which has the lowest point ?	_answer ( NV , _lowest ( NV , ( _state ( V1 ) , _traverse ( NV , V2 ) , _const ( V0 , _riverid ( ' rio grande ' ) ) , _loc ( V1 , V2 ) , _place ( V1 ) ) ) )
how many citizens live in idaho ?	_answer ( NV , ( _population ( NV , V1 ) , _const ( V0 , _stateid ( idaho ) ) ) )
through which states does the ohio river run ?	_answer ( NV , ( _state ( V0 ) , _const ( NV , _riverid ( ohio ) ) , _traverse ( V0 , V1 ) ) )
how many states have cities named montgomery ?	_answer ( NV , _count ( NV , ( _state ( V0 ) , _loc ( NV , V1 ) , _city ( V0 ) , _const ( V0 , _cityid ( montgomery , _ ) ) ) , V2 ) )
what states are next to oregon ?	_answer ( NV , ( _state ( V0 ) , _next_to ( V0 , NV ) , _const ( V0 , _stateid ( oregon ) ) ) )
what major rivers run through north dakota ?	_answer ( NV , ( _major ( V0 ) , _river ( V0 ) , _traverse ( V0 , NV ) , _const ( V0 , _stateid ( ' north dakota ' ) ) ) )
what is the largest city in a state that borders mississippi ?	_answer ( NV , _largest ( V0 , ( _city ( V0 ) , _loc ( V0 , NV ) , _state ( V0 ) , _next_to ( V0 , NV ) , _const ( V0 , _stateid ( mississippi ) ) ) ) )
what are the neighboring states for missouri ?	_answer ( NV , ( _next_to ( V0 , NV ) , _state ( V1 ) , _const ( V0 , _stateid ( missouri ) ) ) )
what states are next to florida ?	_answer ( NV , ( _state ( V0 ) , _next_to ( V0 , NV ) , _const ( V0 , _stateid ( florida ) ) ) )
what is the lowest point of north carolina ?	_answer ( NV , _lowest ( V0 , ( _place ( V0 ) , _loc ( V0 , NV ) , _const ( V0 , _stateid ( ' north carolina ' ) ) ) ) )
where is death valley ?	_answer ( NV , ( _loc ( NV , V1 ) , _const ( V0 , _placeid ( ' death valley ' ) ) ) )
what are the rivers of california ?	_answer ( NV , ( _river ( V0 ) , _loc ( V0 , NV ) , _const ( V0 , _stateid ( california ) ) ) )
which state is the largest city in pennsylvania in ?	_answer ( NV , ( _state ( V0 ) , _largest ( NV , ( _city ( V0 ) , _loc ( V0 , NV ) , _const ( V0 , _stateid ( pennsylvania ) ) ) ) , _loc ( V1 , V2 ) ) )
what is the population density in the state with capital indianapolis ?	_answer ( NV , ( _density ( NV , V1 ) , _state ( V0 ) , _loc ( NV , V1 ) , _capital ( V0 ) , _const ( V0 , _cityid ( indianapolis , _ ) ) ) )
how many cities does hawaii have ?	_answer ( NV , _count ( NV , ( _city ( V0 ) , _const ( NV , _stateid ( hawaii ) ) , _loc ( V1 , V0 ) ) , V2 ) )
what states does the mississippi run through ?	_answer ( NV , ( _state ( V0 ) , _const ( NV , _riverid ( mississippi ) ) , _river ( V0 ) , _traverse ( V0 , V1 ) ) )
how many states have cities named chicago ?	_answer ( NV , _count ( NV , ( _state ( V0 ) , _loc ( NV , V1 ) , _city ( V0 ) , _const ( V0 , _cityid ( chicago , _ ) ) ) , V2 ) )
what is the major cities in kentucky ?	_answer ( NV , ( _major ( V0 ) , _city ( V0 ) , _loc ( V0 , NV ) , _const ( V0 , _stateid ( kentucky ) ) ) )
how many states border on the state whose capital is houston ?	_answer ( NV , _count ( NV , ( _state ( V0 ) , _next_to ( V0 , NV ) , _state ( V0 ) , _loc ( NV , V1 ) , _capital ( V0 ) , _const ( V0 , _cityid ( houston , _ ) ) ) , V3 ) )
what is the smallest state bordering kansas ?	_answer ( NV , _smallest ( V0 , ( _state ( V0 ) , _next_to ( V0 , NV ) , _const ( V0 , _stateid ( kansas ) ) ) ) )
what are the rivers of virginia ?	_answer ( NV , ( _river ( V0 ) , _loc ( V0 , NV ) , _const ( V0 , _stateid ( virginia ) ) ) )
what cities in georgia have the highest populations ?	_answer ( NV , _largest ( NV , ( _city ( V1 ) , _loc ( V1 , NV ) , _const ( V0 , _stateid ( georgia ) ) , _population ( V2 , V1 ) ) ) )
what is the capital of the south dakota state ?	_answer ( NV , ( _capital ( V0 ) , _loc ( V0 , NV ) , _const ( V0 , _stateid ( ' south dakota ' ) ) , _state ( V0 ) ) )
how many major cities are in new york ?	_answer ( NV , _count ( NV , ( _major ( V0 ) , _city ( V0 ) , _loc ( V0 , NV ) , _const ( V0 , _stateid ( ' new york ' ) ) ) , V2 ) )
what is the longest river that flows through maryland ?	_answer ( NV , _longest ( V0 , ( _river ( V0 ) , _traverse ( V0 , NV ) , _const ( V0 , _stateid ( maryland ) ) ) ) )
which state is the largest city in massachusetts in ?	_answer ( NV , ( _state ( V0 ) , _largest ( NV , ( _city ( V0 ) , _loc ( V0 , NV ) , _const ( V0 , _stateid ( massachusetts ) ) ) ) , _loc ( V1 , V2 ) ) )
what is the largest state traversed by the rio grande ?	_answer ( NV , _largest ( V0 , ( _state ( V0 ) , _traverse ( NV , V1 ) , _const ( V0 , _riverid ( ' rio grande ' ) ) ) ) )
how many states border the rio grande ?	_answer ( NV , _count ( NV , ( _state ( V0 ) , _next_to ( V0 , NV ) , _const ( V0 , _riverid ( ' rio grande ' ) ) , _river ( V0 ) ) , V2 ) )
how many major cities are in north dakota ?	_answer ( NV , _count ( NV , ( _major ( V0 ) , _city ( V0 ) , _loc ( V0 , NV ) , _const ( V0 , _stateid ( ' north dakota ' ) ) ) , V2 ) )
how many states does the rio grande river run through ?	_answer ( NV , _count ( NV , ( _state ( V0 ) , _const ( NV , _riverid ( ' rio grande ' ) ) , _traverse ( V0 , V1 ) ) , V2 ) )
where is the highest point in california ?	_answer ( NV , _highest ( V0 , ( _place ( V0 ) , _loc ( V0 , NV ) , _const ( V0 , _stateid ( california ) ) ) ) )
number of citizens in boston ?	_answer ( NV , ( _population ( NV , V1 ) , _const ( V0 , _cityid ( boston , _ ) ) ) )
what are the populations of the states through which the rio grande run ?	_answer ( NV , ( _population ( NV , V1 ) , _state ( V0 ) , _const ( NV , _riverid ( ' rio grande ' ) ) , _river ( V0 ) , _traverse ( V0 , V1 ) ) )
which states does the ohio river run through ?	_answer ( NV , ( _state ( V0 ) , _const ( NV , _riverid ( ohio ) ) , _traverse ( V0 , V1 ) ) )
what is the lowest elevation in utah ?	_answer ( NV , _lowest ( V0 , ( _place ( V0 ) , _loc ( V0 , NV ) , _const ( V0 , _stateid ( utah ) ) ) ) )
what is the smallest city in alabama ?	_answer ( NV , _smallest ( V0 , ( _city ( V0 ) , _loc ( V0 , NV ) , _const ( V0 , _stateid ( alabama ) ) ) ) )
give me the cities which are in new york ?	_answer ( NV , ( _city ( V0 ) , _loc ( V0 , NV ) , _const ( V0 , _stateid ( ' new york ' ) ) ) )
name all the rivers in maryland ?	_answer ( NV , ( _river ( V0 ) , _loc ( V0 , NV ) , _const ( V0 , _stateid ( maryland ) ) ) )
what is capital of louisiana ?	_answer ( NV , ( _capital ( V0 ) , _loc ( V0 , NV ) , _const ( V0 , _stateid ( louisiana ) ) ) )
what is capital of minnesota ?	_answer ( NV , ( _capital ( V0 ) , _loc ( V0 , NV ) , _const ( V0 , _stateid ( minnesota ) ) ) )
which rivers flow through idaho ?	_answer ( NV , ( _river ( V0 ) , _traverse ( V0 , NV ) , _const ( V0 , _stateid ( idaho ) ) ) )
which states do missouri river flow through ?	_answer ( NV , ( _state ( V0 ) , _const ( NV , _riverid ( missouri ) ) , _river ( V0 ) , _traverse ( V0 , V1 ) ) )
what states have a city named sacramento ?	_answer ( NV , ( _state ( V0 ) , _loc ( NV , V1 ) , _const ( V0 , _cityid ( sacramento , _ ) ) ) )
what cities in new mexico have the highest number of citizens ?	_answer ( NV , _largest ( NV , ( _city ( V1 ) , _loc ( V1 , NV ) , _const ( V0 , _stateid ( ' new mexico ' ) ) , _population ( V2 , V1 ) ) ) )
what are the populations of states through which the ohio river run ?	_answer ( NV , ( _population ( NV , V1 ) , _state ( V0 ) , _const ( NV , _riverid ( ohio ) ) , _traverse ( V0 , V1 ) ) )
how long is the rio grande river ?	_answer ( NV , ( _len ( NV , V1 ) , _const ( V0 , _riverid ( ' rio grande ' ) ) ) )
which states does the missouri river run through ?	_answer ( NV , ( _state ( V0 ) , _const ( NV , _riverid ( missouri ) ) , _traverse ( V0 , V1 ) ) )
what is the highest point in the state with capital sacramento ?	_answer ( NV , _highest ( V0 , ( _place ( V0 ) , _loc ( V0 , NV ) , _state ( V0 ) , _loc ( NV , V1 ) , _capital ( V0 ) , _const ( V0 , _cityid ( sacramento , _ ) ) ) ) )
can you tell me the capital of oregon ?	_answer ( NV , ( _capital ( V0 ) , _loc ( V0 , NV ) , _const ( V0 , _stateid ( oregon ) ) ) )
what are the capitals of the states that border maine ?	_answer ( NV , ( _capital ( V0 ) , _loc ( V0 , NV ) , _state ( V0 ) , _next_to ( V0 , NV ) , _const ( V0 , _stateid ( maine ) ) ) )
what is the population density in the state with capital indianapolis ?	_answer ( NV , ( _density ( NV , V1 ) , _state ( V0 ) , _loc ( NV , V1 ) , _capital ( V0 ) , _const ( V0 , _cityid ( indianapolis , _ ) ) ) )
which state has the rio grande river ?	_answer ( NV , ( _state ( V0 ) , _loc ( NV , V1 ) , _const ( V0 , _riverid ( ' rio grande ' ) ) , _river ( V0 ) ) )
how many people live in albany ?	_answer ( NV , ( _population ( NV , V1 ) , _const ( V0 , _cityid ( albany , _ ) ) ) )
what states neighbor west virginia ?	_answer ( NV , ( _state ( V0 ) , _next_to ( V0 , NV ) , _const ( V0 , _stateid ( ' west virginia ' ) ) ) )
how many citizens in baton rouge ?	_answer ( NV , ( _population ( NV , V1 ) , _const ( V0 , _cityid ( ' baton rouge ' , _ ) ) ) )
what is the largest city in colorado ?	_answer ( NV , _largest ( V0 , ( _city ( V0 ) , _loc ( V0 , NV ) , _const ( V0 , _stateid ( colorado ) ) ) ) )
how big is the city of scotts valley ?	_answer ( NV , ( _size ( NV , V1 ) , _const ( V0 , _cityid ( ' scotts valley ' , _ ) ) ) )
what state is fort wayne located in ?	_answer ( NV , ( _state ( V0 ) , _const ( NV , _cityid ( ' fort wayne ' , _ ) ) , _loc ( V0 , V1 ) ) )
where is death valley ?	_answer ( NV , ( _loc ( NV , V1 ) , _const ( V0 , _placeid ( ' death valley ' ) ) ) )
what states in the united states have a city of dallas ?	_answer ( NV , ( _state ( V0 ) , _loc ( V0 , NV ) , _const ( V0 , _countryid ( usa ) ) , _loc ( NV , V2 ) , _const ( V0 , _cityid ( dallas , _ ) ) ) )
what is the highest mountain in arkansas ?	_answer ( NV , _highest ( V0 , ( _mountain ( V0 ) , _loc ( V0 , NV ) , _const ( V0 , _stateid ( arkansas ) ) ) ) )
where is maryland ?	_answer ( NV , ( _loc ( NV , V1 ) , _const ( V0 , _stateid ( maryland ) ) ) )
what is the smallest state bordering north dakota ?	_answer ( NV , _smallest ( V0 , ( _state ( V0 ) , _next_to ( V0 , NV ) , _const ( V0 , _stateid ( ' north dakota ' ) ) ) ) )
what is the size of pennsylvania ?	_answer ( NV , ( _size ( NV , V1 ) , _const ( V0 , _stateid ( pennsylvania ) ) ) )
what cities in georgia have the highest populations ?	_answer ( NV , _largest ( NV , ( _city ( V1 ) , _loc ( V1 , NV ) , _const ( V0 , _stateid ( georgia ) ) , _population ( V2 , V1 ) ) ) )
how many major cities are in new york ?	_answer ( NV , _count ( NV , ( _major ( V0 ) , _city ( V0 ) , _loc ( V0 , NV ) , _const ( V0 , _stateid ( ' new york ' ) ) ) , V2 ) )
what states have cities named boston ?	_answer ( NV , ( _state ( V0 ) , _loc ( NV , V1 ) , _city ( V0 ) , _const ( V0 , _cityid ( boston , _ ) ) ) )
what is the largest of the state that the red river runs through ?	_answer ( NV , _largest ( V0 , ( _state ( V0 ) , _const ( NV , _riverid ( red ) ) , _traverse ( V0 , V1 ) ) ) )
what is the longest river that flows through new york ?	_answer ( NV , _longest ( V0 , ( _river ( V0 ) , _traverse ( V0 , NV ) , _const ( V0 , _stateid ( ' new york ' ) ) ) ) )
how many rivers are found in oregon ?	_answer ( NV , _count ( NV , ( _river ( V0 ) , _loc ( V0 , NV ) , _const ( V0 , _stateid ( oregon ) ) ) , V2 ) )
how many states does the rio grande flow through ?	_answer ( NV , _count ( NV , ( _state ( V0 ) , _const ( NV , _riverid ( ' rio grande ' ) ) , _river ( V0 ) , _traverse ( V0 , V1 ) ) , V2 ) )
what is the area of north dakota in square kilometers ?	_answer ( NV , ( _area ( NV , V1 ) , _const ( V0 , _stateid ( ' north dakota ' ) ) ) )
what states have a city named denver ?	_answer ( NV , ( _state ( V0 ) , _loc ( NV , V1 ) , _const ( V0 , _cityid ( denver , _ ) ) ) )
what state which the colorado river runs through has the largest population ?	_answer ( NV , _largest ( NV , ( _state ( V1 ) , _const ( NV , _riverid ( colorado ) ) , _traverse ( V0 , V2 ) , _population ( V2 , V1 ) ) ) )
how many cities does kansas have ?	_answer ( NV , _count ( NV , ( _city ( V0 ) , _const ( NV , _stateid ( kansas ) ) , _loc ( V1 , V0 ) ) , V2 ) )
how many states have cities or towns named pittsburgh ?	_answer ( NV , _count ( NV , ( _state ( V0 ) , _loc ( NV , V1 ) , _city ( V0 ) , _const ( V0 , _cityid ( pittsburgh , _ ) ) ) , V2 ) )
states bordering nevada ?	_answer ( NV , ( _state ( V0 ) , _next_to ( V0 , NV ) , _const ( V0 , _stateid ( nevada ) ) ) )
what is the largest city in states that border maine ?	_answer ( NV , _largest ( V0 , ( _city ( V0 ) , _loc ( V0 , NV ) , _state ( V0 ) , _next_to ( V0 , NV ) , _const ( V0 , _stateid ( maine ) ) ) ) )
what are the major cities of hawaii ?	_answer ( NV , ( _major ( V0 ) , _city ( V0 ) , _loc ( V0 , NV ) , _const ( V0 , _stateid ( hawaii ) ) ) )
how many people are there in oregon ?	_answer ( NV , ( _population ( NV , V1 ) , _const ( V0 , _stateid ( oregon ) ) ) )
how big is montana ?	_answer ( NV , ( _size ( NV , V1 ) , _const ( V0 , _stateid ( montana ) ) ) )
what are the lakes in states bordering arkansas ?	_answer ( NV , ( _lake ( V0 ) , _loc ( V0 , NV ) , _state ( V0 ) , _next_to ( V0 , NV ) , _const ( V0 , _stateid ( arkansas ) ) ) )
people in columbus ?	_answer ( NV , ( _population ( NV , V1 ) , _const ( V0 , _cityid ( columbus , _ ) ) ) )
how many states have cities named seattle ?	_answer ( NV , _count ( NV , ( _state ( V0 ) , _loc ( NV , V1 ) , _city ( V0 ) , _const ( V0 , _cityid ( seattle , _ ) ) ) , V2 ) )
what states have towns named san jose ?	_answer ( NV , ( _state ( V0 ) , _loc ( NV , V1 ) , _const ( V0 , _cityid ( ' san jose ' , _ ) ) ) )
what is the population of the major cities in florida ?	_answer ( NV , ( _population ( NV , V1 ) , _major ( V0 ) , _city ( V0 ) , _loc ( V0 , NV ) , _const ( V0 , _stateid ( florida ) ) ) )
what states border states that border states that border states that border california ?	_answer ( NV , ( _state ( V0 ) , _next_to ( V0 , NV ) , _state ( V0 ) , _next_to ( V0 , NV ) , _state ( V0 ) , _next_to ( V0 , NV ) , _state ( V0 ) , _next_to ( V0 , NV ) , _const ( V0 , _stateid ( california ) ) ) )
how many rivers in wyoming are longer than the red ?	_answer ( NV , _count ( NV , ( _river ( V0 ) , _loc ( V0 , NV ) , _const ( V0 , _stateid ( wyoming ) ) , _longer ( V1 , NV ) , _const ( V0 , _riverid ( red ) ) ) , V3 ) )
what is the biggest river in louisiana ?	_answer ( NV , _largest ( V0 , ( _river ( V0 ) , _loc ( V0 , NV ) , _const ( V0 , _stateid ( louisiana ) ) ) ) )
what states border states that border utah ?	_answer ( NV , ( _state ( V0 ) , _next_to ( V0 , NV ) , _state ( V0 ) , _next_to ( V0 , NV ) , _const ( V0 , _stateid ( utah ) ) ) )
what state is scotts valley the capital of ?	_answer ( NV , ( _state ( V0 ) , _const ( NV , _cityid ( ' scotts valley ' , _ ) ) , _capital ( V0 ) , _loc ( V0 , V1 ) ) )
what states border michigan ?	_answer ( NV , ( _state ( V0 ) , _next_to ( V0 , NV ) , _const ( V0 , _stateid ( michigan ) ) ) )
what is the lowest point of mississippi ?	_answer ( NV , _lowest ( V0 , ( _place ( V0 ) , _loc ( V0 , NV ) , _const ( V0 , _stateid ( mississippi ) ) ) ) )
how many people live in columbus ?	_answer ( NV , ( _population ( NV , V1 ) , _const ( V0 , _cityid ( columbus , _ ) ) ) )
how many rivers in michigan ?	_answer ( NV , _count ( NV , ( _river ( V0 ) , _loc ( V0 , NV ) , _const ( V0 , _stateid ( michigan ) ) ) , V2 ) )
what is the shortest river in delaware ?	_answer ( NV , _shortest ( V0 , ( _river ( V0 ) , _loc ( V0 , NV ) , _const ( V0 , _stateid ( delaware ) ) ) ) )
where is guadalupe peak located ?	_answer ( NV , ( _loc ( NV , V1 ) , _const ( V0 , _placeid ( ' guadalupe peak ' ) ) ) )
what is the largest city in pennsylvania by population ?	_answer ( NV , _largest ( NV , ( _city ( V1 ) , _loc ( V1 , NV ) , _const ( V0 , _stateid ( pennsylvania ) ) , _population ( V2 , V1 ) ) ) )
through which states does the missouri river run ?	_answer ( NV , ( _state ( V0 ) , _const ( NV , _riverid ( missouri ) ) , _traverse ( V0 , V1 ) ) )
how many states have cities named pittsburgh ?	_answer ( NV , _count ( NV , ( _state ( V0 ) , _loc ( NV , V1 ) , _city ( V0 ) , _const ( V0 , _cityid ( pittsburgh , _ ) ) ) , V2 ) )
what state is boston the capital of ?	_answer ( NV , ( _state ( V0 ) , _const ( NV , _cityid ( boston , _ ) ) , _capital ( V0 ) , _loc ( V0 , V1 ) ) )
what are the highest points of states surrounding arkansas ?	_answer ( NV , _highest ( V0 , ( _place ( V0 ) , _loc ( V0 , NV ) , _state ( V0 ) , _next_to ( V0 , NV ) , _const ( V0 , _stateid ( arkansas ) ) ) ) )
what is the adjacent state of kansas ?	_answer ( NV , ( _next_to ( V0 , NV ) , _state ( V1 ) , _const ( V0 , _stateid ( kansas ) ) ) )
how many people live in north dakota ?	_answer ( NV , ( _population ( NV , V1 ) , _const ( V0 , _stateid ( ' north dakota ' ) ) ) )
what is the biggest city in virginia ?	_answer ( NV , _largest ( V0 , ( _city ( V0 ) , _loc ( V0 , NV ) , _const ( V0 , _stateid ( virginia ) ) ) ) )
what can you tell me about the population of nebraska ?	_answer ( NV , ( _population ( NV , V1 ) , _const ( V0 , _stateid ( nebraska ) ) ) )
what are the capital cities of the states which border mississippi ?	_answer ( NV , ( _capital ( V0 ) , _city ( V0 ) , _loc ( V0 , NV ) , _state ( V0 ) , _next_to ( V0 , NV ) , _const ( V0 , _stateid ( mississippi ) ) ) )
what are the populations of the states through which the red run ?	_answer ( NV , ( _population ( NV , V1 ) , _state ( V0 ) , _const ( NV , _riverid ( red ) ) , _river ( V0 ) , _traverse ( V0 , V1 ) ) )
through which states does the mississippi river flow ?	_answer ( NV , ( _state ( V0 ) , _const ( NV , _riverid ( mississippi ) ) , _traverse ( V0 , V1 ) ) )
how high is death valley ?	_answer ( NV , ( _elevation ( NV , V1 ) , _const ( V0 , _placeid ( ' death valley ' ) ) ) )
how many people stay in pennsylvania ?	_answer ( NV , ( _population ( NV , V1 ) , _const ( V0 , _stateid ( pennsylvania ) ) ) )
what rivers are in minnesota ?	_answer ( NV , ( _river ( V0 ) , _loc ( V0 , NV ) , _const ( V0 , _stateid ( minnesota ) ) ) )
what are the capitals of the states that border new hampshire ?	_answer ( NV , ( _capital ( V0 ) , _loc ( V0 , NV ) , _state ( V0 ) , _next_to ( V0 , NV ) , _const ( V0 , _stateid ( ' new hampshire ' ) ) ) )
states bordering louisiana ?	_answer ( NV , ( _state ( V0 ) , _next_to ( V0 , NV ) , _const ( V0 , _stateid ( louisiana ) ) ) )
what is the city in nevada with the largest population ?	_answer ( NV , _largest ( NV , ( _city ( V1 ) , _loc ( V1 , NV ) , _const ( V0 , _stateid ( nevada ) ) , _population ( V2 , V1 ) ) ) )
what are the rivers in the state of virginia ?	_answer ( NV , ( _river ( V0 ) , _loc ( V0 , NV ) , _state ( V0 ) , _const ( V0 , _stateid ( virginia ) ) ) )
what states border states that border maine ?	_answer ( NV , ( _state ( V0 ) , _next_to ( V0 , NV ) , _state ( V0 ) , _next_to ( V0 , NV ) , _const ( V0 , _stateid ( maine ) ) ) )
what are the populations of the states through which the ohio river runs ?	_answer ( NV , ( _population ( NV , V1 ) , _state ( V0 ) , _const ( NV , _riverid ( ohio ) ) , _river ( V0 ) , _traverse ( V0 , V1 ) ) )
which is the lowest point of the states that the ohio river runs through ?	_answer ( NV , _lowest ( V0 , ( _place ( V0 ) , _loc ( V0 , NV ) , _state ( V0 ) , _const ( NV , _riverid ( ohio ) ) , _traverse ( V0 , V1 ) ) ) )
what wisconsin city has the largest population ?	_answer ( NV , _largest ( NV , ( _const ( NV , _stateid ( wisconsin ) ) , _city ( V2 ) , _loc ( V2 , V0 ) , _population ( V2 , V1 ) ) ) )
which states does the rio grande run through ?	_answer ( NV , ( _state ( V0 ) , _const ( NV , _riverid ( ' rio grande ' ) ) , _traverse ( V0 , V1 ) ) )
how many rivers are found in new mexico ?	_answer ( NV , _count ( NV , ( _river ( V0 ) , _loc ( V0 , NV ) , _const ( V0 , _stateid ( ' new mexico ' ) ) ) , V2 ) )
of the states washed by the ohio river which has the lowest point ?	_answer ( NV , _lowest ( NV , ( _state ( V1 ) , _traverse ( NV , V2 ) , _const ( V0 , _riverid ( ohio ) ) , _loc ( V1 , V2 ) , _place ( V1 ) ) ) )
how many people are in the state of ohio ?	_answer ( NV , ( _population ( NV , V1 ) , _const ( V0 , _stateid ( ohio ) ) ) )
what are the cities in massachusetts ?	_answer ( NV , ( _city ( V0 ) , _loc ( V0 , NV ) , _const ( V0 , _stateid ( massachusetts ) ) ) )
how many major rivers cross north dakota ?	_answer ( NV , _count ( NV , ( _major ( V0 ) , _river ( V0 ) , _traverse ( V0 , NV ) , _const ( V0 , _stateid ( ' north dakota ' ) ) ) , V2 ) )
how many people stay in oklahoma ?	_answer ( NV , ( _population ( NV , V1 ) , _const ( V0 , _stateid ( oklahoma ) ) ) )
which states border new hampshire ?	_answer ( NV , ( _state ( V0 ) , _next_to ( V0 , NV ) , _const ( V0 , _stateid ( ' new hampshire ' ) ) ) )
what is the lowest elevation in oregon ?	_answer ( NV , _lowest ( V0 , ( _place ( V0 ) , _loc ( V0 , NV ) , _const ( V0 , _stateid ( oregon ) ) ) ) )
what are the biggest rivers in minnesota ?	_answer ( NV , _longest ( V0 , ( _river ( V0 ) , _loc ( V0 , NV ) , _const ( V0 , _stateid ( minnesota ) ) ) ) )
what is the population of new york ?	_answer ( NV , ( _population ( NV , V1 ) , _const ( V0 , _cityid ( ' new york ' , _ ) ) ) )
what are the populations of the states through which the mississippi runs ?	_answer ( NV , ( _population ( NV , V1 ) , _state ( V0 ) , _const ( NV , _riverid ( mississippi ) ) , _river ( V0 ) , _traverse ( V0 , V1 ) ) )
what is the capital of the state alaska ?	_answer ( NV , ( _capital ( V0 ) , _loc ( V0 , NV ) , _state ( V0 ) , _const ( V0 , _stateid ( alaska ) ) ) )
what are the populations of the states through which the rio grande runs ?	_answer ( NV , ( _population ( NV , V1 ) , _state ( V0 ) , _const ( NV , _riverid ( ' rio grande ' ) ) , _river ( V0 ) , _traverse ( V0 , V1 ) ) )
what is the length of the ohio river in illinois ?	_answer ( NV , ( _len ( NV , V1 ) , _const ( V0 , _riverid ( ohio ) ) , _river ( V0 ) , _loc ( V0 , NV ) , _const ( V0 , _stateid ( illinois ) ) ) )
which states does not border south dakota ?	_answer ( NV , ( _state ( V0 ) , \+ ( _next_to ( V0 , NV ) , _const ( V0 , _stateid ( ' south dakota ' ) ) ) ) )
what is the most populated state bordering arizona ?	_answer ( NV , _largest ( NV , ( _population ( V1 , V0 ) , _state ( V1 ) , _next_to ( V1 , NV ) , _const ( V0 , _stateid ( arizona ) ) ) ) )
how many rivers in new york ?	_answer ( NV , _count ( NV , ( _river ( V0 ) , _loc ( V0 , NV ) , _const ( V0 , _stateid ( ' new york ' ) ) ) , V2 ) )
what is the size of the capital of maryland ?	_answer ( NV , ( _size ( NV , V1 ) , _capital ( V0 ) , _loc ( V0 , NV ) , _const ( V0 , _stateid ( maryland ) ) ) )
what states are next to ohio ?	_answer ( NV , ( _state ( V0 ) , _next_to ( V0 , NV ) , _const ( V0 , _stateid ( ohio ) ) ) )
which states does the colorado pass through ?	_answer ( NV , ( _state ( V0 ) , _const ( NV , _riverid ( colorado ) ) , _traverse ( V0 , V1 ) ) )
what are the populations of the states through which the ohio river runs ?	_answer ( NV , ( _population ( NV , V1 ) , _state ( V0 ) , _const ( NV , _riverid ( ohio ) ) , _traverse ( V0 , V1 ) ) )
what is the number of neighboring states for pennsylvania ?	_answer ( NV , _count ( NV , ( _state ( V0 ) , _next_to ( V0 , NV ) , _const ( V0 , _stateid ( pennsylvania ) ) ) , V2 ) )
where is the highest point in idaho ?	_answer ( NV , _highest ( V0 , ( _place ( V0 ) , _loc ( V0 , NV ) , _const ( V0 , _stateid ( idaho ) ) ) ) )
how many states border the rio grande river ?	_answer ( NV , _count ( NV , ( _state ( V0 ) , _next_to ( V0 , NV ) , _const ( V0 , _riverid ( ' rio grande ' ) ) , _river ( V0 ) ) , V2 ) )
what state which the red runs through has the largest population ?	_answer ( NV , _largest ( NV , ( _state ( V1 ) , _const ( NV , _riverid ( red ) ) , _traverse ( V0 , V2 ) , _population ( V2 , V1 ) ) ) )
how high is the highest point in kansas ?	_answer ( NV , ( _elevation ( NV , V1 ) , _highest ( V0 , ( _place ( V0 ) , _loc ( V0 , NV ) , _const ( V0 , _stateid ( kansas ) ) ) ) ) )
how many citizens live in washington ?	_answer ( NV , ( _population ( NV , V1 ) , _const ( V0 , _stateid ( washington ) ) ) )
how many states border mississippi and border california ?	_answer ( NV , _count ( NV , ( _state ( V0 ) , _next_to ( V0 , NV ) , _const ( V0 , _stateid ( mississippi ) ) , _next_to ( V1 , NV ) , _const ( V0 , _stateid ( california ) ) ) , V3 ) )
what are the neighboring states for wisconsin ?	_answer ( NV , ( _next_to ( V0 , NV ) , _state ( V1 ) , _const ( V0 , _stateid ( wisconsin ) ) ) )
what is the number of neighboring states for north dakota ?	_answer ( NV , _count ( NV , ( _state ( V0 ) , _next_to ( V0 , NV ) , _const ( V0 , _stateid ( ' north dakota ' ) ) ) , V2 ) )
how many states border north dakota ?	_answer ( NV , _count ( NV , ( _state ( V0 ) , _next_to ( V0 , NV ) , _const ( V0 , _stateid ( ' north dakota ' ) ) ) , V2 ) )
what are the major cities in wisconsin ?	_answer ( NV , ( _major ( V0 ) , _city ( V0 ) , _loc ( V0 , NV ) , _const ( V0 , _stateid ( wisconsin ) ) ) )
what is capital of illinois ?	_answer ( NV , ( _capital ( V0 ) , _loc ( V0 , NV ) , _const ( V0 , _stateid ( illinois ) ) ) )
how many states does the colorado river run through ?	_answer ( NV , _count ( NV , ( _state ( V0 ) , _const ( NV , _riverid ( colorado ) ) , _traverse ( V0 , V1 ) ) , V2 ) )
what state is boston the capital of ?	_answer ( NV , ( _state ( V0 ) , _const ( NV , _cityid ( boston , _ ) ) , _capital ( V0 ) , _loc ( V0 , V1 ) ) )
how many states have a city named dover ?	_answer ( NV , _count ( NV , ( _state ( V0 ) , _loc ( NV , V1 ) , _const ( V0 , _cityid ( dover , _ ) ) ) , V2 ) )
how many people live in mississippi ?	_answer ( NV , ( _population ( NV , V1 ) , _const ( V0 , _stateid ( mississippi ) ) ) )
what rivers run through the states that border the state with the capital riverside ?	_answer ( NV , ( _river ( V0 ) , _traverse ( V0 , NV ) , _state ( V0 ) , _next_to ( V0 , NV ) , _state ( V0 ) , _loc ( NV , V1 ) , _capital ( V0 ) , _const ( V0 , _cityid ( riverside , _ ) ) ) )
how many citizens in ohio ?	_answer ( NV , ( _population ( NV , V1 ) , _const ( V0 , _stateid ( ohio ) ) ) )
what state that borders rhode island is the largest ?	_answer ( NV , _largest ( V0 , ( _state ( V0 ) , _next_to ( V0 , NV ) , _const ( V0 , _stateid ( ' rhode island ' ) ) ) ) )
how many major cities are in new hampshire ?	_answer ( NV , _count ( NV , ( _major ( V0 ) , _city ( V0 ) , _loc ( V0 , NV ) , _const ( V0 , _stateid ( ' new hampshire ' ) ) ) , V2 ) )
how high is the highest point of ohio ?	_answer ( NV , ( _elevation ( NV , V1 ) , _highest ( V0 , ( _place ( V0 ) , _loc ( V0 , NV ) , _const ( V0 , _stateid ( ohio ) ) ) ) ) )
which rivers are in oklahoma ?	_answer ( NV , ( _river ( V0 ) , _loc ( V0 , NV ) , _const ( V0 , _stateid ( oklahoma ) ) ) )
what are the rivers in the state of wyoming ?	_answer ( NV , ( _river ( V0 ) , _loc ( V0 , NV ) , _state ( V0 ) , _const ( V0 , _stateid ( wyoming ) ) ) )
how high is the highest point of hawaii ?	_answer ( NV , ( _elevation ( NV , V1 ) , _highest ( V0 , ( _place ( V0 ) , _loc ( V0 , NV ) , _const ( V0 , _stateid ( hawaii ) ) ) ) ) )
what are the populations of all the major cities in oklahoma ?	_answer ( NV , ( _population ( NV , V1 ) , _major ( V0 ) , _city ( V0 ) , _loc ( V0 , NV ) , _const ( V0 , _stateid ( oklahoma ) ) ) )
where is the highest point in nevada ?	_answer ( NV , _highest ( V0 , ( _place ( V0 ) , _loc ( V0 , NV ) , _const ( V0 , _stateid ( nevada ) ) ) ) )
what is the highest point in the state with the capital springfield ?	_answer ( NV , _highest ( V0 , ( _place ( V0 ) , _loc ( V0 , NV ) , _state ( V0 ) , _loc ( NV , V1 ) , _capital ( V0 ) , _const ( V0 , _cityid ( springfield , _ ) ) ) ) )
what rivers run through the states that border the state with the capital dover ?	_answer ( NV , ( _river ( V0 ) , _traverse ( V0 , NV ) , _state ( V0 ) , _next_to ( V0 , NV ) , _state ( V0 ) , _loc ( NV , V1 ) , _capital ( V0 ) , _const ( V0 , _cityid ( dover , _ ) ) ) )
what state is sacramento located in ?	_answer ( NV , ( _state ( V0 ) , _const ( NV , _cityid ( sacramento , _ ) ) , _loc ( V0 , V1 ) ) )
how long is the rio grande ?	_answer ( NV , ( _len ( NV , V1 ) , _const ( V0 , _riverid ( ' rio grande ' ) ) ) )
what is the largest city in states that border new york ?	_answer ( NV , _largest ( V0 , ( _city ( V0 ) , _loc ( V0 , NV ) , _state ( V0 ) , _next_to ( V0 , NV ) , _const ( V0 , _stateid ( ' new york ' ) ) ) ) )
what is the city in colorado with the largest population ?	_answer ( NV , _largest ( NV , ( _city ( V1 ) , _loc ( V1 , NV ) , _const ( V0 , _stateid ( colorado ) ) , _population ( V2 , V1 ) ) ) )
how many states does the rio grande river flow through ?	_answer ( NV , _count ( NV , ( _state ( V0 ) , _const ( NV , _riverid ( ' rio grande ' ) ) , _river ( V0 ) , _traverse ( V0 , V1 ) ) , V2 ) )
what are the capital cities of the states which border arizona ?	_answer ( NV , ( _capital ( V0 ) , _city ( V0 ) , _loc ( V0 , NV ) , _state ( V0 ) , _next_to ( V0 , NV ) , _const ( V0 , _stateid ( arizona ) ) ) )
what is the capital of the maryland state ?	_answer ( NV , ( _capital ( V0 ) , _loc ( V0 , NV ) , _const ( V0 , _stateid ( maryland ) ) , _state ( V0 ) ) )
what states neighbor california ?	_answer ( NV , ( _state ( V0 ) , _next_to ( V0 , NV ) , _const ( V0 , _stateid ( california ) ) ) )
how many states border missouri ?	_answer ( NV , _count ( NV , ( _state ( V0 ) , _next_to ( V0 , NV ) , _const ( V0 , _stateid ( missouri ) ) ) , V2 ) )
how many cities named boulder are there in the usa ?	_answer ( NV , _count ( NV , ( _city ( V0 ) , _const ( V0 , _cityid ( boulder , _ ) ) , _loc ( V0 , NV ) , _const ( V0 , _countryid ( usa ) ) ) , V2 ) )
where is the highest point in massachusetts ?	_answer ( NV , _highest ( V0 , ( _place ( V0 ) , _loc ( V0 , NV ) , _const ( V0 , _stateid ( massachusetts ) ) ) ) )
which states do rio grande flow through ?	_answer ( NV , ( _state ( V0 ) , _const ( NV , _riverid ( ' rio grande ' ) ) , _river ( V0 ) , _traverse ( V0 , V1 ) ) )
what states are next to the rhode island ?	_answer ( NV , ( _state ( V0 ) , _next_to ( V0 , NV ) , _const ( V0 , _stateid ( ' rhode island ' ) ) ) )
what is the population of boulder ga ?	_answer ( NV , ( _population ( NV , V1 ) , _const ( V0 , _cityid ( boulder , _ ) ) ) )
what states are next to pennsylvania ?	_answer ( NV , ( _state ( V0 ) , _next_to ( V0 , NV ) , _const ( V0 , _stateid ( pennsylvania ) ) ) )
what states border states that border states that border tennessee ?	_answer ( NV , ( _state ( V0 ) , _next_to ( V0 , NV ) , _state ( V0 ) , _next_to ( V0 , NV ) , _state ( V0 ) , _next_to ( V0 , NV ) , _const ( V0 , _stateid ( tennessee ) ) ) )
where is mount mckinley ?	_answer ( NV , ( _loc ( NV , V1 ) , _const ( V0 , _placeid ( ' mount mckinley ' ) ) ) )
what states are next to the vermont ?	_answer ( NV , ( _state ( V0 ) , _next_to ( V0 , NV ) , _const ( V0 , _stateid ( vermont ) ) ) )
how many states have cities named pittsburgh ?	_answer ( NV , _count ( NV , ( _state ( V0 ) , _loc ( NV , V1 ) , _city ( V0 ) , _const ( V0 , _cityid ( pittsburgh , _ ) ) ) , V2 ) )
which states adjoin rhode island ?	_answer ( NV , ( _state ( V0 ) , _next_to ( V0 , NV ) , _const ( V0 , _stateid ( ' rhode island ' ) ) ) )
which states does the red river pass through ?	_answer ( NV , ( _state ( V0 ) , _const ( NV , _riverid ( red ) ) , _traverse ( V0 , V1 ) ) )
what state has the capital montgomery ?	_answer ( NV , ( _state ( V0 ) , _loc ( NV , V1 ) , _capital ( V0 ) , _const ( V0 , _cityid ( montgomery , _ ) ) ) )
what state borders colorado ?	_answer ( NV , ( _state ( V0 ) , _next_to ( V0 , NV ) , _const ( V0 , _stateid ( colorado ) ) ) )
what states border pennsylvania ?	_answer ( NV , ( _state ( V0 ) , _next_to ( V0 , NV ) , _const ( V0 , _stateid ( pennsylvania ) ) ) )
what are the rivers of virginia ?	_answer ( NV , ( _river ( V0 ) , _loc ( V0 , NV ) , _const ( V0 , _stateid ( virginia ) ) ) )
how many rivers does indiana have ?	_answer ( NV , _count ( NV , ( _river ( V0 ) , _const ( NV , _stateid ( indiana ) ) , _loc ( V1 , V0 ) ) , V2 ) )
how many states does the colorado run through ?	_answer ( NV , _count ( NV , ( _state ( V0 ) , _const ( NV , _riverid ( colorado ) ) , _traverse ( V0 , V1 ) ) , V2 ) )
which is the lowest point of the states that the missouri river runs through ?	_answer ( NV , _lowest ( V0 , ( _place ( V0 ) , _loc ( V0 , NV ) , _state ( V0 ) , _const ( NV , _riverid ( missouri ) ) , _traverse ( V0 , V1 ) ) ) )
what is the size of the capital of mississippi ?	_answer ( NV , ( _size ( NV , V1 ) , _capital ( V0 ) , _loc ( V0 , NV ) , _const ( V0 , _stateid ( mississippi ) ) ) )
what are the populations of states through which the rio grande run ?	_answer ( NV , ( _population ( NV , V1 ) , _state ( V0 ) , _const ( NV , _riverid ( ' rio grande ' ) ) , _river ( V0 ) , _traverse ( V0 , V1 ) ) )
how many rivers does new mexico have ?	_answer ( NV , _count ( NV , ( _river ( V0 ) , _const ( NV , _stateid ( ' new mexico ' ) ) , _loc ( V1 , V0 ) ) , V2 ) )
which capitals are in the states that border pennsylvania ?	_answer ( NV , ( _capital ( V0 ) , _loc ( V0 , NV ) , _state ( V0 ) , _next_to ( V0 , NV ) , _const ( V0 , _stateid ( pennsylvania ) ) ) )
what is the largest city in a state that borders washington ?	_answer ( NV , _largest ( V0 , ( _city ( V0 ) , _loc ( V0 , NV ) , _state ( V0 ) , _next_to ( V0 , NV ) , _const ( V0 , _stateid ( washington ) ) ) ) )
what are major rivers in utah ?	_answer ( NV , ( _major ( V0 ) , _river ( V0 ) , _loc ( V0 , NV ) , _const ( V0 , _stateid ( utah ) ) ) )
what river flows through minnesota ?	_answer ( NV , ( _river ( V0 ) , _traverse ( V0 , NV ) , _const ( V0 , _stateid ( minnesota ) ) ) )
what states are next to the iowa ?	_answer ( NV , ( _state ( V0 ) , _next_to ( V0 , NV ) , _const ( V0 , _stateid ( iowa ) ) ) )
what state is seattle in ?	_answer ( NV , ( _state ( V0 ) , _const ( NV , _cityid ( seattle , _ ) ) , _loc ( V0 , V1 ) ) )
what is the population of the capital of the largest state through which the ohio river runs ?	_answer ( NV , ( _population ( NV , V1 ) , _capital ( V0 ) , _loc ( V0 , NV ) , _largest ( V0 , ( _state ( V0 ) , _const ( NV , _riverid ( ohio ) ) , _traverse ( V0 , V1 ) ) ) ) )
how many states does the rio grande river flow through ?	_answer ( NV , _count ( NV , ( _state ( V0 ) , _const ( NV , _riverid ( ' rio grande ' ) ) , _river ( V0 ) , _traverse ( V0 , V1 ) ) , V2 ) )
in what state is guadalupe peak ?	_answer ( NV , ( _loc ( NV , V1 ) , _state ( V1 ) , _const ( V0 , _placeid ( ' guadalupe peak ' ) ) ) )
what is the size of the capital of louisiana ?	_answer ( NV , ( _size ( NV , V1 ) , _capital ( V0 ) , _loc ( V0 , NV ) , _const ( V0 , _stateid ( louisiana ) ) ) )
what rivers flow through states that utah borders ?	_answer ( NV , ( _river ( V0 ) , _traverse ( V0 , NV ) , _state ( V0 ) , _const ( NV , _stateid ( utah ) ) , _next_to ( V0 , V1 ) ) )
how many people stay in montana ?	_answer ( NV , ( _population ( NV , V1 ) , _const ( V0 , _stateid ( montana ) ) ) )
in what state is death valley ?	_answer ( NV , ( _loc ( NV , V1 ) , _state ( V1 ) , _const ( V0 , _placeid ( ' death valley ' ) ) ) )
what is the population of the major cities in iowa ?	_answer ( NV , ( _population ( NV , V1 ) , _major ( V0 ) , _city ( V0 ) , _loc ( V0 , NV ) , _const ( V0 , _stateid ( iowa ) ) ) )
what states high point are higher than that of florida ?	_answer ( NV , ( _state ( V0 ) , _high_point ( V0 , NV ) , _higher ( V0 , NV ) , _high_point ( NV , V1 ) , _const ( V0 , _stateid ( florida ) ) ) )
what states high point are higher than that of wisconsin ?	_answer ( NV , ( _state ( V0 ) , _high_point ( V0 , NV ) , _higher ( V0 , NV ) , _high_point ( NV , V1 ) , _const ( V0 , _stateid ( wisconsin ) ) ) )
which is the lowest point of the states that the mississippi river runs through ?	_answer ( NV , _lowest ( V0 , ( _place ( V0 ) , _loc ( V0 , NV ) , _state ( V0 ) , _const ( NV , _riverid ( mississippi ) ) , _traverse ( V0 , V1 ) ) ) )
what states does the red run through ?	_answer ( NV , ( _state ( V0 ) , _const ( NV , _riverid ( red ) ) , _traverse ( V0 , V1 ) ) )
how many rivers in oregon are longer than the colorado river ?	_answer ( NV , _count ( NV , ( _river ( V0 ) , _loc ( V0 , NV ) , _const ( V0 , _stateid ( oregon ) ) , _longer ( V1 , NV ) , _const ( V0 , _riverid ( colorado ) ) ) , V3 ) )
in which state is kalamazoo ?	_answer ( NV , ( _loc ( NV , V1 ) , _state ( V1 ) , _const ( V0 , _cityid ( kalamazoo , _ ) ) ) )
which rivers run through states bordering alaska ?	_answer ( NV , ( _river ( V0 ) , _traverse ( V0 , NV ) , _state ( V0 ) , _next_to ( V0 , NV ) , _const ( V0 , _stateid ( alaska ) ) ) )
what are the states that the missouri river run through ?	_answer ( NV , ( _state ( V0 ) , _const ( NV , _riverid ( missouri ) ) , _traverse ( V0 , V1 ) ) )
what is the capital of the state new mexico ?	_answer ( NV , ( _capital ( V0 ) , _loc ( V0 , NV ) , _state ( V0 ) , _const ( V0 , _stateid ( ' new mexico ' ) ) ) )
which states does the colorado river pass through ?	_answer ( NV , ( _state ( V0 ) , _const ( NV , _riverid ( colorado ) ) , _traverse ( V0 , V1 ) ) )
which states border mississippi ?	_answer ( NV , ( _state ( V0 ) , _next_to ( V0 , NV ) , _const ( V0 , _stateid ( mississippi ) ) ) )
name the major lakes in maine ?	_answer ( NV , ( _major ( V0 ) , _lake ( V0 ) , _loc ( V0 , NV ) , _const ( V0 , _stateid ( maine ) ) ) )
how many citizens in rochester ?	_answer ( NV , ( _population ( NV , V1 ) , _const ( V0 , _cityid ( rochester , _ ) ) ) )
what is the city in pennsylvania with the largest population ?	_answer ( NV , _largest ( NV , ( _city ( V1 ) , _loc ( V1 , NV ) , _const ( V0 , _stateid ( pennsylvania ) ) , _population ( V2 , V1 ) ) ) )
what are the rivers of colorado ?	_answer ( NV , ( _river ( V0 ) , _loc ( V0 , NV ) , _const ( V0 , _stateid ( colorado ) ) ) )
what states border the rio grande river ?	_answer ( NV , ( _state ( V0 ) , _next_to ( V0 , NV ) , _const ( V0 , _riverid ( ' rio grande ' ) ) , _river ( V0 ) ) )
people in dallas ?	_answer ( NV , ( _population ( NV , V1 ) , _const ( V0 , _cityid ( dallas , _ ) ) ) )
what are the populations of the states through which the colorado runs ?	_answer ( NV , ( _population ( NV , V1 ) , _state ( V0 ) , _const ( NV , _riverid ( colorado ) ) , _traverse ( V0 , V1 ) ) )
states bordering arizona ?	_answer ( NV , ( _state ( V0 ) , _next_to ( V0 , NV ) , _const ( V0 , _stateid ( arizona ) ) ) )
what is the area of south carolina in square kilometers ?	_answer ( NV , ( _area ( NV , V1 ) , _const ( V0 , _stateid ( ' south carolina ' ) ) ) )
how many major cities are there in minnesota ?	_answer ( NV , _count ( NV , ( _major ( V0 ) , _city ( V0 ) , _loc ( V0 , NV ) , _const ( V0 , _stateid ( minnesota ) ) ) , V2 ) )
which capitals are in the states that border idaho ?	_answer ( NV , ( _capital ( V0 ) , _loc ( V0 , NV ) , _state ( V0 ) , _next_to ( V0 , NV ) , _const ( V0 , _stateid ( idaho ) ) ) )
how many states does michigan border ?	_answer ( NV , _count ( NV , ( _state ( V0 ) , _const ( NV , _stateid ( michigan ) ) , _next_to ( V0 , V1 ) ) , V2 ) )
what states have cities named new york ?	_answer ( NV , ( _state ( V0 ) , _loc ( NV , V1 ) , _city ( V0 ) , _const ( V0 , _cityid ( ' new york ' , _ ) ) ) )
states bordering massachusetts ?	_answer ( NV , ( _state ( V0 ) , _next_to ( V0 , NV ) , _const ( V0 , _stateid ( massachusetts ) ) ) )
what states are next to iowa ?	_answer ( NV , ( _state ( V0 ) , _next_to ( V0 , NV ) , _const ( V0 , _stateid ( iowa ) ) ) )
what is the population of springfield ?	_answer ( NV , ( _population ( NV , V1 ) , _const ( V0 , _cityid ( springfield , _ ) ) ) )
how high is the highest point of texas ?	_answer ( NV , ( _elevation ( NV , V1 ) , _highest ( V0 , ( _place ( V0 ) , _loc ( V0 , NV ) , _const ( V0 , _stateid ( texas ) ) ) ) ) )
what is the capital of the maine state ?	_answer ( NV , ( _capital ( V0 ) , _loc ( V0 , NV ) , _const ( V0 , _stateid ( maine ) ) , _state ( V0 ) ) )
how many rivers in alabama ?	_answer ( NV , _count ( NV , ( _river ( V0 ) , _loc ( V0 , NV ) , _const ( V0 , _stateid ( alabama ) ) ) , V2 ) )
what are the populations of the states through which the rio grande river runs ?	_answer ( NV , ( _population ( NV , V1 ) , _state ( V0 ) , _const ( NV , _riverid ( ' rio grande ' ) ) , _traverse ( V0 , V1 ) ) )
where is the highest point in ohio ?	_answer ( NV , _highest ( V0 , ( _place ( V0 ) , _loc ( V0 , NV ) , _const ( V0 , _stateid ( ohio ) ) ) ) )
what is the biggest city in arkansas ?	_answer ( NV , _largest ( V0 , ( _city ( V0 ) , _loc ( V0 , NV ) , _const ( V0 , _stateid ( arkansas ) ) ) ) )
how many rivers are there in tennessee ?	_answer ( NV , _count ( NV , ( _river ( V0 ) , _loc ( V0 , NV ) , _const ( V0 , _stateid ( tennessee ) ) ) , V2 ) )
what is the capital of ohio ?	_answer ( NV , ( _capital ( V0 ) , _loc ( V0 , NV ) , _const ( V0 , _stateid ( ohio ) ) ) )
what is the largest city of new mexico ?	_answer ( NV , _largest ( V0 , ( _city ( V0 ) , _loc ( V0 , NV ) , _const ( V0 , _stateid ( ' new mexico ' ) ) ) ) )
what states have towns named san francisco ?	_answer ( NV , ( _state ( V0 ) , _loc ( NV , V1 ) , _const ( V0 , _cityid ( ' san francisco ' , _ ) ) ) )
what is the population density in the state with capital houston ?	_answer ( NV , ( _density ( NV , V1 ) , _state ( V0 ) , _loc ( NV , V1 ) , _capital ( V0 ) , _const ( V0 , _cityid ( houston , _ ) ) ) )
how many people live in the capital of new hampshire ?	_answer ( NV , ( _population ( NV , V1 ) , _capital ( V0 ) , _loc ( V0 , NV ) , _const ( V0 , _stateid ( ' new hampshire ' ) ) ) )
what states border states that border nebraska ?	_answer ( NV , ( _state ( V0 ) , _next_to ( V0 , NV ) , _state ( V0 ) , _next_to ( V0 , NV ) , _const ( V0 , _stateid ( nebraska ) ) ) )
how many rivers in montana ?	_answer ( NV , _count ( NV , ( _river ( V0 ) , _loc ( V0 , NV ) , _const ( V0 , _stateid ( montana ) ) ) , V2 ) )
what state which the missouri river runs through has the largest population ?	_answer ( NV , _largest ( NV , ( _state ( V1 ) , _const ( NV , _riverid ( missouri ) ) , _traverse ( V0 , V2 ) , _population ( V2 , V1 ) ) ) )
which states have a major city named kalamazoo ?	_answer ( NV , ( _state ( V0 ) , _loc ( NV , V1 ) , _major ( V0 ) , _city ( V0 ) , _const ( V0 , _cityid ( kalamazoo , _ ) ) ) )
what is the population of the major cities in georgia ?	_answer ( NV , ( _population ( NV , V1 ) , _major ( V0 ) , _city ( V0 ) , _loc ( V0 , NV ) , _const ( V0 , _stateid ( georgia ) ) ) )
how many people live in boulder ?	_answer ( NV , ( _population ( NV , V1 ) , _const ( V0 , _cityid ( boulder , _ ) ) ) )
what is the area of pennsylvania in square kilometers ?	_answer ( NV , ( _area ( NV , V1 ) , _const ( V0 , _stateid ( pennsylvania ) ) ) )
how long is mississippi ?	_answer ( NV , ( _len ( NV , V1 ) , _const ( V0 , _riverid ( mississippi ) ) ) )
number of citizens in atlanta ?	_answer ( NV , ( _population ( NV , V1 ) , _const ( V0 , _cityid ( atlanta , _ ) ) ) )
what is the length of the potomac in oregon ?	_answer ( NV , ( _len ( NV , V1 ) , _const ( V0 , _riverid ( potomac ) ) , _river ( V0 ) , _loc ( V0 , NV ) , _const ( V0 , _stateid ( oregon ) ) ) )
what is the area of kansas in square kilometers ?	_answer ( NV , ( _area ( NV , V1 ) , _const ( V0 , _stateid ( kansas ) ) ) )
how many states have cities named new orleans ?	_answer ( NV , _count ( NV , ( _state ( V0 ) , _loc ( NV , V1 ) , _city ( V0 ) , _const ( V0 , _cityid ( ' new orleans ' , _ ) ) ) , V2 ) )
which state is the city des moines located in ?	_answer ( NV , ( _state ( V0 ) , _city ( NV ) , _const ( V0 , _cityid ( ' des moines ' , _ ) ) , _loc ( V0 , V1 ) ) )
name the major lakes in wyoming ?	_answer ( NV , ( _major ( V0 ) , _lake ( V0 ) , _loc ( V0 , NV ) , _const ( V0 , _stateid ( wyoming ) ) ) )
what is the height of mount whitney ?	_answer ( NV , ( _elevation ( NV , V1 ) , _const ( V0 , _placeid ( ' mount whitney ' ) ) ) )
what are the capitals of the states that border washington ?	_answer ( NV , ( _capital ( V0 ) , _loc ( V0 , NV ) , _state ( V0 ) , _next_to ( V0 , NV ) , _const ( V0 , _stateid ( washington ) ) ) )
what is the largest state bordering kansas ?	_answer ( NV , _largest ( V0 , ( _state ( V0 ) , _next_to ( V0 , NV ) , _const ( V0 , _stateid ( kansas ) ) ) ) )
what is the largest state traversed by the colorado ?	_answer ( NV , _largest ( V0 , ( _state ( V0 ) , _traverse ( NV , V1 ) , _const ( V0 , _riverid ( colorado ) ) ) ) )
where is mount mckinley located ?	_answer ( NV , ( _loc ( NV , V1 ) , _const ( V0 , _placeid ( ' mount mckinley ' ) ) ) )
how long is the mississippi in miles ?	_answer ( NV , ( _len ( NV , V1 ) , _const ( V0 , _riverid ( mississippi ) ) , _river ( V0 ) ) )
how many states border on the state whose capital is albany ?	_answer ( NV , _count ( NV , ( _state ( V0 ) , _next_to ( V0 , NV ) , _state ( V0 ) , _loc ( NV , V1 ) , _capital ( V0 ) , _const ( V0 , _cityid ( albany , _ ) ) ) , V3 ) )
what states border states which the missouri river runs through ?	_answer ( NV , ( _state ( V0 ) , _next_to ( V0 , NV ) , _state ( V0 ) , _const ( NV , _riverid ( missouri ) ) , _traverse ( V0 , V1 ) ) )
what is the largest state traversed by the ohio river ?	_answer ( NV , _largest ( V0 , ( _state ( V0 ) , _traverse ( NV , V1 ) , _const ( V0 , _riverid ( ohio ) ) ) ) )
what is the biggest river in iowa ?	_answer ( NV , _largest ( V0 , ( _river ( V0 ) , _loc ( V0 , NV ) , _const ( V0 , _stateid ( iowa ) ) ) ) )
what is the biggest city in tennessee ?	_answer ( NV , _largest ( V0 , ( _city ( V0 ) , _loc ( V0 , NV ) , _const ( V0 , _stateid ( tennessee ) ) ) ) )
what is the city in louisiana with the largest population ?	_answer ( NV , _largest ( NV , ( _city ( V1 ) , _loc ( V1 , NV ) , _const ( V0 , _stateid ( louisiana ) ) , _population ( V2 , V1 ) ) ) )
what is the area of the state with the capital riverside ?	_answer ( NV , ( _area ( NV , V1 ) , _state ( V0 ) , _loc ( NV , V1 ) , _capital ( V0 ) , _const ( V0 , _cityid ( riverside , _ ) ) ) )
what is the size of mississippi ?	_answer ( NV , ( _size ( NV , V1 ) , _const ( V0 , _stateid ( mississippi ) ) ) )
which state is the city kalamazoo located in ?	_answer ( NV , ( _state ( V0 ) , _city ( NV ) , _const ( V0 , _cityid ( kalamazoo , _ ) ) , _loc ( V0 , V1 ) ) )
what is the largest city in alaska by population ?	_answer ( NV , _largest ( NV , ( _city ( V1 ) , _loc ( V1 , NV ) , _const ( V0 , _stateid ( alaska ) ) , _population ( V2 , V1 ) ) ) )
what are the populations of states through which the red river run ?	_answer ( NV , ( _population ( NV , V1 ) , _state ( V0 ) , _const ( NV , _riverid ( red ) ) , _river ( V0 ) , _traverse ( V0 , V1 ) ) )
what is the lowest point in idaho ?	_answer ( NV , _lowest ( V0 , ( _place ( V0 ) , _loc ( V0 , NV ) , _const ( V0 , _stateid ( idaho ) ) ) ) )
what states neighbor iowa ?	_answer ( NV , ( _state ( V0 ) , _next_to ( V0 , NV ) , _const ( V0 , _stateid ( iowa ) ) ) )
what is the biggest city in hawaii ?	_answer ( NV , _largest ( V0 , ( _city ( V0 ) , _loc ( V0 , NV ) , _const ( V0 , _stateid ( hawaii ) ) ) ) )
where is vermont ?	_answer ( NV , ( _loc ( NV , V1 ) , _const ( V0 , _stateid ( vermont ) ) ) )
what are the biggest rivers in illinois ?	_answer ( NV , _longest ( V0 , ( _river ( V0 ) , _loc ( V0 , NV ) , _const ( V0 , _stateid ( illinois ) ) ) ) )
what is the shortest river in north dakota ?	_answer ( NV , _shortest ( V0 , ( _river ( V0 ) , _loc ( V0 , NV ) , _const ( V0 , _stateid ( ' north dakota ' ) ) ) ) )
how many people stay in iowa ?	_answer ( NV , ( _population ( NV , V1 ) , _const ( V0 , _stateid ( iowa ) ) ) )
what is the length of the rio grande river in kansas ?	_answer ( NV , ( _len ( NV , V1 ) , _const ( V0 , _riverid ( ' rio grande ' ) ) , _river ( V0 ) , _loc ( V0 , NV ) , _const ( V0 , _stateid ( kansas ) ) ) )
where is the highest point in michigan ?	_answer ( NV , _highest ( V0 , ( _place ( V0 ) , _loc ( V0 , NV ) , _const ( V0 , _stateid ( michigan ) ) ) ) )
what is the average population per square km in utah ?	_answer ( NV , ( _density ( NV , V1 ) , _const ( V0 , _stateid ( utah ) ) ) )
what is the city in florida with the largest population ?	_answer ( NV , _largest ( NV , ( _city ( V1 ) , _loc ( V1 , NV ) , _const ( V0 , _stateid ( florida ) ) , _population ( V2 , V1 ) ) ) )
how many states have cities or towns named scotts valley ?	_answer ( NV , _count ( NV , ( _state ( V0 ) , _loc ( NV , V1 ) , _city ( V0 ) , _const ( V0 , _cityid ( ' scotts valley ' , _ ) ) ) , V2 ) )
what is the longest river in arizona ?	_answer ( NV , _longest ( V0 , ( _river ( V0 ) , _loc ( V0 , NV ) , _const ( V0 , _stateid ( arizona ) ) ) ) )
what states border states which the mississippi river runs through ?	_answer ( NV , ( _state ( V0 ) , _next_to ( V0 , NV ) , _state ( V0 ) , _const ( NV , _riverid ( mississippi ) ) , _traverse ( V0 , V1 ) ) )
what river runs through tennessee ?	_answer ( NV , ( _river ( V0 ) , _traverse ( V0 , NV ) , _const ( V0 , _stateid ( tennessee ) ) ) )
what is the population of the major cities in pennsylvania ?	_answer ( NV , ( _population ( NV , V1 ) , _major ( V0 ) , _city ( V0 ) , _loc ( V0 , NV ) , _const ( V0 , _stateid ( pennsylvania ) ) ) )
how many rivers are in maryland ?	_answer ( NV , _count ( NV , ( _river ( V0 ) , _loc ( V0 , NV ) , _const ( V0 , _stateid ( maryland ) ) ) , V2 ) )
what is the population density in the state with capital sacramento ?	_answer ( NV , ( _density ( NV , V1 ) , _state ( V0 ) , _loc ( NV , V1 ) , _capital ( V0 ) , _const ( V0 , _cityid ( sacramento , _ ) ) ) )
what is the population in dallas ?	_answer ( NV , ( _population ( NV , V1 ) , _const ( V0 , _cityid ( dallas , _ ) ) ) )
